date,text,comments_count,likes_count,reposts_count,activity
1602590409,"–ö–û–ù–ö–£–†–°! –í—ã–∏–≥—Ä–∞–π—Ç–µ —É—Ä–æ–∫–∏ –∞–Ω–≥–ª–∏–π—Å–∫–æ–≥–æ –∏ –±—å—é—Ç–∏-–±–æ–∫—Å—ã üéÅ

Skyeng –∏ ¬´–ü–æ–¥—Ä—É–∂–∫–∞¬ª –æ–±—ä–µ–¥–∏–Ω–∏–ª–∏—Å—å, —á—Ç–æ–±—ã –ø–æ—Ä–∞–¥–æ–≤–∞—Ç—å –≤–∞—Å –ø–∞—Å–º—É—Ä–Ω–æ–π –æ—Å–µ–Ω—å—é üçÇ –∏ —Ä–∞–∑—ã–≥—Ä–∞—Ç—å –æ–±—â–∏–π –ø—Ä–∏–∑ ‚Äî 3 —Å–µ—Ä—Ç–∏—Ñ–∏–∫–∞—Ç–∞ –Ω–∞ —á–µ—Ç—ã—Ä–µ —É—Ä–æ–∫–∞ –∞–Ω–≥–ª–∏–π—Å–∫–æ–≥–æ –∏ 3 –±—å—é—Ç–∏-–±–æ–∫—Å–∞ üòç

–£—Å–ª–æ–≤–∏—è —É—á–∞—Å—Ç–∏—è –æ—á–µ–Ω—å –ø—Ä–æ—Å—Ç—ã–µ: 

‚úÖ –ü–æ–¥–ø–∏—à–∏—Ç–µ—Å—å –Ω–∞ –≥—Ä—É–ø–ø—ã Skyeng –∏ [club32598214|¬´–ü–æ–¥—Ä—É–∂–∫–∏¬ª] –≤–æ –í–ö–æ–Ω—Ç–∞–∫—Ç–µ –∏ –ø–æ—Å—Ç–∞–≤—å—Ç–µ ‚ûï –ø–æ–¥ —ç—Ç–æ–π –∑–∞–ø–∏—Å—å—é. 

–°—Ä–µ–¥–∏ –≤—Å–µ—Ö –∫–æ–º–º–µ–Ω—Ç–∞—Ç–æ—Ä–æ–≤ –º—ã –≤—ã–±–µ—Ä–µ–º –ø–æ–±–µ–¥–∏—Ç–µ–ª–µ–π —Å –ø–æ–º–æ—â—å—é —Ä–∞–Ω–¥–æ–º–∞–π–∑–µ—Ä–∞. –ß–µ–º –±–æ–ª—å—à–µ –∫–æ–º–º–µ–Ω—Ç–∞—Ä–∏–µ–≤, —Ç–µ–º –≤—ã—à–µ —à–∞–Ω—Å—ã –Ω–∞ –ø–æ–±–µ–¥—É! –ò—Ç–æ–≥–∏ –∫–æ–Ω–∫—É—Ä—Å–∞ –ø–æ–¥–≤–µ–¥–µ–º 20 –æ–∫—Ç—è–±—Ä—è. 
–í—Å–µ–º —É–¥–∞—á–∏! üíô",10962,117,2,11081
1554800244,"–ß–µ—Ä–µ–∑ 15 –¥–Ω–µ–π –≤—ã –Ω–∞–∫–∞—á–∞–µ—Ç–µ –ø—Ä–µ—Å—Å –∏ –≤—ã—É—á–∏—Ç–µ –∞–Ω–≥–ª–∏–π—Å–∫–∏–π. –ù—É, –º–æ–∂–µ—Ç, –ø—Ä–æ –ø—Ä–µ—Å—Å –º—ã –ø–æ–≥–æ—Ä—è—á–∏–ª–∏—Å—å. 

–ó–∞–ø—É—Å–∫–∞–µ–º –º–∞—Ä–∞—Ñ–æ–Ω ¬´–§–æ—Ä–º–∏—Ä—É–µ–º –ø—Ä–∏–≤—ã—á–∫—É —É—á–∏—Ç—å –∞–Ω–≥–ª–∏–π—Å–∫–∏–π –∑–∞ 15 –¥–Ω–µ–π¬ª.

–ö–¢–û –ú–û–ñ–ï–¢ –£–ß–ê–°–¢–í–û–í–ê–¢–¨?
–í—Å–µ. –≠—Ç–æ –±–µ—Å–ø–ª–∞—Ç–Ω–æ, –∞ –≤–æ–∑—Ä–∞—Å—Ç –∏ —É—Ä–æ–≤–µ–Ω—å –∞–Ω–≥–ª–∏–π—Å–∫–æ–≥–æ –Ω–µ –≤–∞–∂–µ–Ω. –ì–ª–∞–≤–Ω–æ–µ ‚Äì –∂–µ–ª–∞–Ω–∏–µ —É—Å–∫–æ—Ä–∏—Ç—å—Å—è –≤ –∏–∑—É—á–µ–Ω–∏–∏ —è–∑—ã–∫–∞. 

–ß–¢–û –¢–ê–ú –ë–£–î–ï–¢?
–ö–æ—Ä–æ—Ç–∫–∏–µ —Å–æ–≤–µ—Ç—ã: –∫–∞–∫ –≤–Ω–µ–¥—Ä–∏—Ç—å –∞–Ω–≥–ª–∏–π—Å–∫–∏–π –≤ –∂–∏–∑–Ω—å, –¥–∞–∂–µ –µ—Å–ª–∏ —Å–æ–≤—Å–µ–º –Ω–µ—Ç –Ω–∞ –Ω–µ–≥–æ –≤—Ä–µ–º–µ–Ω–∏. –í–∞–º –Ω—É–∂–Ω–æ –±—É–¥–µ—Ç –≤—Å–µ–≥–æ 15 –º–∏–Ω—É—Ç –≤ –¥–µ–Ω—å. –ê —Å—Ä–µ–¥–∏ —Ç–µ—Ö, –∫—Ç–æ –¥–æ–±–µ–∂–∏—Ç –¥–æ –∫–æ–Ω—Ü–∞, –º—ã —Ä–∞–∑—ã–≥—Ä–∞–µ–º 5 –±–µ—Å–ø–ª–∞—Ç–Ω—ã—Ö –∫—É—Ä—Å–æ–≤ –∞–Ω–≥–ª–∏–π—Å–∫–æ–≥–æ –≤ Skyeng. 

–ò –ö–ê–ö–û–ô –†–ï–ó–£–õ–¨–¢–ê–¢?
–ú–∞—Ä–∞—Ñ–æ–Ω –ø–æ–º–æ–∂–µ—Ç –≤–∞–º –ø—Ä–æ–∫–∞—á–∞—Ç—å —Å–µ–±—è –∏ –ø–æ–ø–∞—Å—Ç—å –≤ –∫–ª–∞—Å—Å–Ω—É—é —Å—Ä–µ–¥—É. –í–º–µ—Å—Ç–µ —Å –≤–∞–º–∏ –±—É–¥—É—Ç —É—á–∏—Ç—å—Å—è –¥—Ä—É–≥–∏–µ —É—á–∞—Å—Ç–Ω–∏–∫–∏: –æ–±—â–∞–π—Ç–µ—Å—å, –¥–µ–ª–∏—Ç–µ—Å—å —É—Å–ø–µ—Ö–∞–º–∏ –∏ –Ω–∞—Ö–æ–¥–∏—Ç–µ –¥—Ä—É–∑–µ–π, —Å –∫–æ—Ç–æ—Ä—ã–º–∏ –º–æ–∂–Ω–æ –ø–æ–≥–æ–≤–æ—Ä–∏—Ç—å –Ω–∞ –ª—é–±–æ–º —è–∑—ã–∫–µ :) 

–ù–∞—á–∏–Ω–∞–µ–º: https://vk.com/app6258612_-51890028#lists/5c3ef630f450b97a7135319b&utm_content=marathon&utm_medium=post&utm_source=smm",239,7005,1345,8589
1416930109,"100 –ø–æ–ª–µ–∑–Ω—ã—Ö –∞–Ω–≥–ª–∏–π—Å–∫–∏—Ö —Ñ—Ä–∞–∑
–≠—Ç–∏ —Ñ—Ä–∞–∑—ã –≤—ã—Ä—É—á–∞—Ç –≤ –ª—é–±–æ–π —Å–∏—Ç—É–∞—Ü–∏–∏. –°–æ—Ö—Ä–∞–Ω–∏—Ç–µ, –ø—Ä–∏–≥–æ–¥–∏—Ç—Å—è.

How's life? - –ö–∞–∫ –∂–∏–∑–Ω—å?
It is new to me - –≠—Ç–æ –Ω–æ–≤–æ—Å—Ç—å –¥–ª—è –º–µ–Ω—è
Long time no see! - –î–∞–≤–Ω–æ –Ω–µ –≤–∏–¥–µ–ª–∏—Å—å!
What are you up to? - –ß–µ–º –∑–∞–Ω–∏–º–∞–µ—à—å—Å—è?
See you soon! - –î–æ —Å–∫–æ—Ä–æ–≥–æ!
Good luck! - –£–¥–∞—á–∏!
Things happen - –í—Å—è–∫–æ–µ –±—ã–≤–∞–µ—Ç
Until we meet again! - –î–æ –Ω–æ–≤–æ–π –≤—Å—Ç—Ä–µ—á–∏!
Have a nice day! - –•–æ—Ä–æ—à–µ–≥–æ –¥–Ω—è!
You were saying? - –í—ã —á—Ç–æ-—Ç–æ —Å–∫–∞–∑–∞–ª–∏?
Don‚Äôt worry about it! - –ù–µ –≤–æ–ª–Ω—É–π—Ç–µ—Å—å –æ–± —ç—Ç–æ–º!
Exactly so - –ò–º–µ–Ω–Ω–æ —Ç–∞–∫
It‚Äôs a great idea! - –û—Ç–ª–∏—á–Ω–∞—è –∏–¥–µ—è!
Say hi to ‚Ä¶ - –ü–µ—Ä–µ–¥–∞–≤–∞–π –ø—Ä–∏–≤–µ—Ç ‚Ä¶

–í—Å–µ 100 –ø–æ–ª–µ–∑–Ω—ã—Ö —Ñ—Ä–∞–∑ –≤ –ø—è—Ç–∏ –∫–∞—Ä—Ç–∏–Ω–∫–∞—Ö! –ï—â–µ –Ω–µ—Å–∫–æ–ª—å–∫–æ —Ç—ã—Å—è—á –ø–æ–ø—É–ª—è—Ä–Ω—ã—Ö –∞–Ω–≥–ª–∏–π—Å–∫–∏—Ö —Å–ª–æ–≤ –∏ –≤—ã—Ä–∞–∂–µ–Ω–∏–π –≤ –≥—Ä—É–ø–ø–µ http://vk.com/skyeng

–ù–æ–≤—ã–µ —Ñ—Ä–∞–∑—ã –∫–∞–∂–¥—ã–π –¥–µ–Ω—å.
–ü—Ä–∏—Å–æ–µ–¥–∏–Ω—è–π—Ç–µ—Å—å, —É—á–∏—Ç–µ, –æ–±—â–∞–π—Ç–µ—Å—å.",0,4012,973,4985
1604923204,"–ö–û–ù–ö–£–†–°! –í—ã–∏–≥—Ä–∞–π—Ç–µ —É—Ä–æ–∫–∏ –∞–Ω–≥–ª–∏–π—Å–∫–æ–≥–æ –∏ –±–æ–∫—Å—ã —Å –ü–ü-–±–∞—Ç–æ–Ω—á–∏–∫–∞–º–∏ üéÅ

Skyeng –∏ [club134796912|BOMBBAR] –æ–±—ä–µ–¥–∏–Ω–∏–ª–∏—Å—å, —á—Ç–æ–±—ã —Ä–∞–∑—ã–≥—Ä–∞—Ç—å –æ–±—â–∏–µ –ø—Ä–∏–∑—ã: 

–û—Ç Skyeng:
ü•á –°–µ—Ä—Ç–∏—Ñ–∏–∫–∞—Ç –Ω–∞ 4 —É—Ä–æ–∫–∞ –∞–Ω–≥–ª–∏–π—Å–∫–æ–≥–æ. 
ü•àü•â –ê–±–æ–Ω–µ–º–µ–Ω—Ç—ã –≤ —Ä–∞–∑–≥–æ–≤–æ—Ä–Ω—ã–µ –∫–ª—É–±—ã –Ω–∞ –º–µ—Å—è—Ü. 

–û—Ç Bombbar:
ü•á –≠–∫—Å–∫–ª—é–∑–∏–≤–Ω—ã–π –Ω–∞–±–æ—Ä (–∞—Å—Å–æ—Ä—Ç–∏ —Ä–∞–∑–Ω–æ–π –ø—Ä–æ–¥—É–∫—Ü–∏–∏). 
ü•à –ë–æ–∫—Å –ø–∞–Ω–∫–µ–π–∫–æ–≤. 
ü•â 500 –±–æ–Ω—É—Å–æ–≤. 

–£—Å–ª–æ–≤–∏—è —É—á–∞—Å—Ç–∏—è –æ—á–µ–Ω—å –ø—Ä–æ—Å—Ç—ã–µ: 

‚úÖ –ü–æ–¥–ø–∏—à–∏—Ç–µ—Å—å –Ω–∞ –≥—Ä—É–ø–ø—ã Skyeng –∏ [club134796912|BOMBBAR] –≤–æ –í–ö–æ–Ω—Ç–∞–∫—Ç–µ –∏ –ø–æ—Å—Ç–∞–≤—å—Ç–µ ‚ûï –ø–æ–¥ —ç—Ç–æ–π –∑–∞–ø–∏—Å—å—é. 

–°—Ä–µ–¥–∏ –≤—Å–µ—Ö –∫–æ–º–º–µ–Ω—Ç–∞—Ç–æ—Ä–æ–≤ –º—ã –≤—ã–±–µ—Ä–µ–º –ø–æ–±–µ–¥–∏—Ç–µ–ª–µ–π —Å –ø–æ–º–æ—â—å—é —Ä–∞–Ω–¥–æ–º–∞–π–∑–µ—Ä–∞. –ß–µ–º –±–æ–ª—å—à–µ –∫–æ–º–º–µ–Ω—Ç–∞—Ä–∏–µ–≤, —Ç–µ–º –≤—ã—à–µ —à–∞–Ω—Å—ã –Ω–∞ –ø–æ–±–µ–¥—É! –ò—Ç–æ–≥–∏ –∫–æ–Ω–∫—É—Ä—Å–∞ –ø–æ–¥–≤–µ–¥–µ–º 16 –Ω–æ—è–±—Ä—è. 
–í—Å–µ–º —É–¥–∞—á–∏! üíô",2891,133,6,3030
1568444249,"üòë–ü—Ä–µ–¥–ª–æ–≥–∏ –≤ –∞–Ω–≥–ª–∏–π—Å–∫–æ–º ‚Äî –±–æ–ª—å–Ω–∞—è —Ç–µ–º–∞ –¥–ª—è –≤—Å–µ—Ö, –∫—Ç–æ –∏–∑—É—á–∞–µ—Ç —è–∑—ã–∫. –î–∞ —á–µ–≥–æ —É–∂ —Ç–∞–º ‚Äî –¥–∞–∂–µ –Ω–æ—Å–∏—Ç–µ–ª–∏ –∏–Ω–æ–≥–¥–∞ –≤ –Ω–∏—Ö –ø—É—Ç–∞—é—Ç—Å—è. –ß—Ç–æ–±—ã –≤–∞–º –±—ã–ª–æ –ª–µ–≥—á–µ –∑–∞–ø–æ–º–Ω–∏—Ç—å –ø—Ä–∞–≤–∏–ª–∞ —É–ø–æ—Ç—Ä–µ–±–ª–µ–Ω–∏—è –ø—Ä–µ–¥–ª–æ–≥–æ–≤, –∫–æ—Ç–æ—Ä—ã–µ –ø—É—Ç–∞—é—Ç –æ—Å–æ–±–µ–Ω–Ω–æ —á–∞—Å—Ç–æ, –º—ã —Å–¥–µ–ª–∞–ª–∏ –∫—Ä–∞—Å–∏–≤—ã–µ –∏ –ø–æ–Ω—è—Ç–Ω—ã–µ —Ç–∞–±–ª–∏—á–∫–∏. 

üòé–° –≤–∞—Å - —Ä–µ–ø–æ—Å—Ç –∏ –∫–æ–º–º–µ–Ω–∞—Ä–∏–π.

üî•–ë–µ—Å–ø–ª–∞—Ç–Ω—ã–π –≤–≤–æ–¥–Ω—ã–π —É—Ä–æ–∫ https://skyeng.ru/go/vvyr1",50,1931,445,2426
1574414757,"–ö–æ—Ç –í–∏–∫—Ç–æ—Ä –ø–æ–∫–∞–∑—ã–≤–∞–µ—Ç, –∫–∞–∫ —Å—Ç–∞–ª –ø—Ä–∏—á–∏–Ω–æ–π —Å–∫–∞–Ω–¥–∞–ª–∞ —Å ¬´–ê—ç—Ä–æ—Ñ–ª–æ—Ç–æ–º¬ª, –∏—Å–ø–æ–ª—å–∑—É—è –≤—Å–µ 12 –≤—Ä–µ–º–µ–Ω –∞–Ω–≥–ª–∏–π—Å–∫–æ–≥–æ. 

–û–Ω –ø–æ–º–æ–∂–µ—Ç –≤–∞–º —Ä–∞–∑–æ–±—Ä–∞—Ç—å—Å—è, —á–µ–º Past Simple –æ—Ç–ª–∏—á–∞–µ—Ç—Å—è –æ—Ç Present Perfect –∏ –∏—Å–ø–æ–ª—å–∑—É–µ—Ç—Å—è –ª–∏ –≤ —Ä–µ–∞–ª—å–Ω–æ–π –∂–∏–∑–Ω–∏ Future Perfect Continuous.
–ü–æ–¥–¥–µ—Ä–∂–∏—Ç–µ –í–∏–∫—Ç–æ—Ä–∞ —Ä–µ–ø–æ—Å—Ç–æ–º.üòª",54,1623,203,1880
1561301735,"–ò–≥—Ä–∞–µ–º –≤ —Å–ª–æ–≤–∞. –£ –∫–æ–≥–æ —Å–ª–æ–≤–∞—Ä–Ω—ã–π –∑–∞–ø–∞—Å –±–æ–ª—å—à–µ? 
–ù–∞–ø–∏—à–∏—Ç–µ –≤ –∫–æ–º–º–µ–Ω—Ç–∞—Ä–∏—è—Ö –∞–Ω–≥–ª–∏–π—Å–∫–æ–µ —Å–ª–æ–≤–æ –∏ –µ–≥–æ –ø–µ—Ä–µ–≤–æ–¥ –Ω–∞ –ø–æ—Å–ª–µ–¥–Ω—é—é –±—É–∫–≤—É –ø—Ä–µ–¥—ã–¥—É—â–µ–≥–æ —Å–ª–æ–≤–∞.
Let's play the game! –ù–∞—á–∏–Ω–∞–µ–º.
‚†Ä
Knowledge (–∑–Ω–∞–Ω–∏–µ)
Evening (–≤–µ—á–µ—Ä)
‚¨á",1634,135,3,1772
1587207600,"–ë–µ–∑ —Ñ—Ä–∞–∑–æ–≤—ã—Ö –≥–ª–∞–≥–æ–ª–æ–≤ –º–æ–∂–Ω–æ –ø–æ–Ω–∏–º–∞—Ç—å —Ç–æ–ª—å–∫–æ —Å–∞–º—ã–µ –±–∞–∑–æ–≤—ã–µ –∞–Ω–≥–ª–∏–π—Å–∫–∏–µ –≤—ã—Ä–∞–∂–µ–Ω–∏—è. –ü–æ—Ä–æ–π –∑–Ω–∞—á–µ–Ω–∏–µ –≤—Å–µ–π —Ñ—Ä–∞–∑—ã –∑–∞–≤–∏—Å–∏—Ç –æ—Ç –ø—Ä–µ–¥–ª–æ–≥–∞ –∏–ª–∏ –Ω–∞—Ä–µ—á–∏—è. –ú—ã —Å–æ–±—Ä–∞–ª–∏ —Å–∞–º—ã–µ —Ä–∞—Å–ø—Ä–æ—Å—Ç—Ä–∞–Ω–µ–Ω–Ω—ã–µ —Ñ—Ä–∞–∑–æ–≤—ã–µ –≥–ª–∞–≥–æ–ª—ã ‚Äî —Å–æ—Ö—Ä–∞–Ω—è–π—Ç–µ –∏—Ö, —á—Ç–æ–±—ã –æ–Ω–∏ –≤—Å–µ–≥–¥–∞ –±—ã–ª–∏ –ø–æ–¥ —Ä—É–∫–æ–π.üôÉüôÉ",36,1398,272,1706
1581057787,"–ê–Ω–≥–ª–∏–π—Å–∫–∏–π —Å–Ω–æ–≤–∞ —Å–≤–æ–¥–∏—Ç –Ω–∞—Å —Å —É–º–∞, üòâ–∏ –µ–º—É –≤–æ–æ–±—â–µ –Ω–µ —Å—Ç—ã–¥–Ω–æ. –ù–∏—á–µ–≥–æ, –∏ –Ω–∞ –ø—Ä–∞–≤–∏–ª–∞ —á—Ç–µ–Ω–∏—è –º–æ–∂–Ω–æ –Ω–∞–π—Ç–∏ —É–ø—Ä–∞–≤—É ‚Äî –º—ã —Å–¥–µ–ª–∞–ª–∏ –ø—Ä–æ—Å—Ç—ã–µ –∏ –ø–æ–Ω—è—Ç–Ω—ã–µ –∫–∞—Ä—Ç–æ—á–∫–∏ —Å –æ—Å–Ω–æ–≤–Ω—ã–º–∏ –∑–∞–∫–æ–Ω–æ–º–µ—Ä–Ω–æ—Å—Ç—è–º–∏, –∫–æ–≥–¥–∞ –±—É–∫–≤—ã –ø—Ä–∏—Ç–≤–æ—Ä—è—é—Ç—Å—è –Ω–µ–≤–∏–¥–∏–º—ã–º–∏.

–ï—â–µ –∫–∞—Ä—Ç–æ—á–µ–∫? –°—Ç–∞–≤—å—Ç–µ –ø–ª—é—Å–∏–∫–∏ –≤ –∫–æ–º–º–µ–Ω—Ç–∞—Ä–∏—è—Ö.üôÉ",111,1383,197,1691
1589373062,"–ì–æ—Ç–æ–≤—ã –ª–∏ –≤—ã –∫ –∂–∏–∑–Ω–∏ –≤ –∞–Ω–≥–ª–æ–≥–æ–≤–æ—Ä—è—â–µ–º –≥–æ—Ä–æ–¥–µ? 
–ü–æ–ø—Ä–æ–±—É–π—Ç–µ —Å–≤–æ–∏ —Å–∏–ª—ã –≤ —Å–∏–º—É–ª—è—Ç–æ—Ä–µ Skycity! 
 
–í–∞—Å –∂–¥–µ—Ç –ø—É—Ç–µ—à–µ—Å—Ç–≤–∏–µ –≤ –≤–∏—Ä—Ç—É–∞–ª—å–Ω—ã–π –≥–æ—Ä–æ–¥, –≤ –∫–æ—Ç–æ—Ä–æ–º –≤—Å–µ –≥–æ–≤–æ—Ä—è—Ç –∏ –ø–∏—à—É—Ç –Ω–∞ –∞–Ω–≥–ª–∏–π—Å–∫–æ–º. –£ –≤–∞—Å –µ—Å—Ç—å –¥–æ–º, —Ä–∞–±–æ—Ç–∞, –¥—Ä—É–∑—å—è, –≤—ã –∑–∞–Ω–∏–º–∞–µ—Ç–µ—Å—å —Å–ø–æ—Ä—Ç–æ–º, —Ö–æ–¥–∏—Ç–µ –Ω–∞ —à–æ–ø–ø–∏–Ω–≥ –∏ —Å–≤–∏–¥–∞–Ω–∏—è. –ù–æ –¥–æ—Å—Ç–∞—Ç–æ—á–Ω–æ –ª–∏ –≤–∞—à–∏—Ö –∑–Ω–∞–Ω–∏–π, —á—Ç–æ–±—ã —Å–ø—Ä–∞–≤–∏—Ç—å—Å—è —Å –ø—Ä–æ—Å—Ç—ã–º–∏ –µ–∂–µ–¥–Ω–µ–≤–Ω—ã–º–∏ –¥–µ–ª–∞–º–∏ –∏ —Å—Ç–∞—Ç—å —Å–≤–æ–∏–º –≤ –∏–Ω–æ—Å—Ç—Ä–∞–Ω–Ω–æ–π —Å—Ä–µ–¥–µ? 
 
–ó–∞–π–¥–∏—Ç–µ –≤ –ø—Ä–∏–ª–æ–∂–µ–Ω–∏–µ –∏ –ø—Ä–æ–≤–µ—Ä—å—Ç–µ —Å–µ–±—è: https://vk.com/app7450503 
 
–ò–≥—Ä–∞–π—Ç–µ, –∑–∞—Ä–∞–±–∞—Ç—ã–≤–∞–π—Ç–µ –±–∞–ª–ª—ã –∏ –æ–±–º–µ–Ω–∏–≤–∞–π—Ç–µ –∏—Ö –Ω–∞ –ø–æ–ª–µ–∑–Ω—ã–µ –º–∞—Ç–µ—Ä–∏–∞–ª—ã –∏ —Å–∫–∏–¥–∫–∏ –Ω–∞ —É—Ä–æ–∫–∏ Skyeng. –ê —Å–∞–º—ã–µ –ª—É—á—à–∏–µ –∏–≥—Ä–æ–∫–∏ –ø–æ–ø–∞–¥—É—Ç –Ω–∞ ¬´–∞–ª–ª–µ—é –∑–≤–µ–∑–¥¬ª Skycity –∏ –ø–æ–ª—É—á–∞—Ç —Ñ–∏—Ä–º–µ–Ω–Ω—ã–µ —Ç–æ–ª—Å—Ç–æ–≤–∫–∏ Skyeng! –¢–∞–∫–∂–µ –ø–æ–¥–ø–∏—à–∏—Ç–µ—Å—å –Ω–∞ —Ä–∞—Å—Å—ã–ª–∫—É –≤ –ø—Ä–∏–ª–æ–∂–µ–Ω–∏–∏ –∏ –ø–æ–ª—É—á–∏—Ç–µ –¥–æ–ø–æ–ª–Ω–∏—Ç–µ–ª—å–Ω—ã–π —Å–µ–∫—Ä–µ—Ç–Ω—ã–π –ø—Ä–∏–∑!",84,1479,115,1678
1596104809,–ü–æ–¥–ø–∏—Å—ã–≤–∞–π—Ç–µ—Å—å –Ω–∞ [club51890028|Skyeng],26,1458,156,1640
1569916801,üìöü§ì–ù—É –≤—ã –ø–æ–Ω—è–ª–∏.üëáüèªüòâ,44,1426,81,1551
1583935214,,66,1423,57,1546
1597644180,–í—Å–µ —Å–∞–º—ã–µ –≥–ª–∞–≤–Ω—ã–µ —Ñ—Ä–∞–∑–æ–≤—ã–µ –≥–ª–∞–≥–æ–ª—ã –≤ –∫–∞—Ä—Ç–æ—á–∫–∞—Ö. –°–æ—Ö—Ä–∞–Ω—è–π—Ç–µ —Å–µ–±–µ. üëáüèª,18,1207,233,1458
1574838003,"–ú–µ—Ç–æ–¥–∏—Å—Ç—ã –æ–Ω–ª–∞–π–Ω-—à–∫–æ–ª—ã Skyeng —Å–æ—Å—Ç–∞–≤–∏–ª–∏ —á–µ–∫-–ª–∏—Å—Ç: –∫–∞–∫–∏–µ —Ç–µ–º—ã –∞–Ω–≥–ª–∏–π—Å–∫–æ–π –≥—Ä–∞–º–º–∞—Ç–∏–∫–∏ —É—á–∏—Ç—å –Ω–∞ –∫–∞–∂–¥–æ–º —É—Ä–æ–≤–Ω–µ —è–∑—ã–∫–∞.
üìå–ò –∫–∞–∫ —Ç–æ–ª—å–∫–æ –≤—ã —Å–¥–µ–ª–∞–µ—Ç–µ —Ä–µ–ø–æ—Å—Ç —ç—Ç–æ–π –∑–∞–ø–∏—Å–∏, –∑–∞–ø–∏—à–∏—Ç–µ—Å—å –Ω–∞ –ø–µ—Ä–≤–æ–µ –ë–ï–°–ü–õ–ê–¢–ù–û–ï –∑–∞–Ω—è—Ç–∏–µ –≤ Skyeng –ø–æ —Å—Å—ã–ª–∫–µ: http://skyeng.ru/go/freezan1212",35,1175,231,1441
1591446471,"–ü—Ä–æ—Å—Ç–æ–µ –æ–±—ä—è—Å–Ω–µ–Ω–∏–µ –≤—Å–µ—Ö –≤—Ä–µ–º–µ–Ω –≤ –∞–Ω–≥–ª–∏–π—Å–∫–æ–º. 
–ü–∏—à–∏—Ç–µ ¬´+¬ª –≤ –∫–æ–º–º–µ–Ω—Ç–∞—Ä–∏—è—Ö, –µ—Å–ª–∏ —Ö–æ—Ç–∏—Ç–µ –≤–µ—Ä—Å–∏—é —Å –ø–µ—Ä–µ–≤–æ–¥–æ–º. üòâ

‚úÖ –ó–∞–ø–∏—à–∏—Ç–µ—Å—å –Ω–∞ –±–µ—Å–ø–ª–∞—Ç–Ω—ã–π –∏–º–µ–π–ª-–∫—É—Ä—Å –ø–æ 12 –≤—Ä–µ–º–µ–Ω–∞–º –∞–Ω–≥–ª–∏–π—Å–∫–æ–≥–æ https://go.skyeng.ru/alltimesnk",104,1186,140,1430
1424708125,"60 –∞–Ω–≥–ª–∏–π—Å–∫–∏—Ö —Ñ—Ä–∞–∑ –Ω–∞ –≤—Å–µ —Å–ª—É—á–∞–∏ –∂–∏–∑–Ω–∏
–¢–∞–∫–æ–≥–æ –≤—ã –≤ —Ä–∞–∑–≥–æ–≤–æ—Ä–Ω–∏–∫–∞—Ö –Ω–µ –Ω–∞–π–¥–µ—Ç–µ!

In our city, bears usually walk the streets. - –£ –Ω–∞—Å –≤ –≥–æ—Ä–æ–¥–µ –º–µ–¥–≤–µ–¥–∏ —Ö–æ–¥—è—Ç –ø–æ —É–ª–∏—Ü–∞–º.
What should I do with such a huge pile of money? - –ß—Ç–æ –º–Ω–µ –¥–µ–ª–∞—Ç—å —Å —ç—Ç–æ–π –∫—É—á–µ–π –¥–µ–Ω–µ–≥?
There is a mouse living in my grandpa's beard. - –£ –º–æ–µ–≥–æ –¥–µ–¥—É—à–∫–∏ –≤ –±–æ—Ä–æ–¥–µ –∂–∏–≤–µ—Ç –º—ã—à—å.
If I don't get something to eat right now, I'm going to die. - –ï—Å–ª–∏ —è —Å–µ–π—á–∞—Å –Ω–µ –ø–æ–µ–º, —Ç–æ —É–º—Ä—É.
I just hate ra—Åcoons! - –Ø –Ω–µ–Ω–∞–≤–∏–∂—É –µ–Ω–æ—Ç–æ–≤.
Can I stay at your place for a while? - –ú–æ–∂–Ω–æ —è –ø–æ–∂–∏–≤—É –Ω–µ–º–Ω–æ–≥–æ —É —Ç–µ–±—è?
This is the best boot I've ever had. - –≠—Ç–æ —Å–∞–º—ã–π –ª—É—á—à–∏–π —Å–∞–ø–æ–≥ –∏–∑ —Ç–µ—Ö, —á—Ç–æ —è –Ω–æ—Å–∏–ª–∞.
And now I'll sing! - –°–µ–π—á–∞—Å —Å–ø–æ—é!
How can I find the best local hot-dog spot? - –ì–¥–µ –∑–¥–µ—Å—å –ø—Ä–æ–¥–∞—é—Ç —Å–∞–º—ã–µ –≤–∫—É—Å–Ω—ã–µ —Ö–æ—Ç-–¥–æ–≥–∏?
I usually visit my shrink on Mondays. - –û–±—ã—á–Ω–æ —è —Ö–æ–∂—É –∫ –ø—Å–∏—Ö–æ—Ç–µ—Ä–∞–ø–µ–≤—Ç—É –ø–æ –ø–æ–Ω–µ–¥–µ–ª—å–Ω–∏–∫–∞–º.

–í—Å–µ 60 —Ñ—Ä–∞–∑ –≤ —à–µ—Å—Ç–∏ –∫–∞—Ä—Ç–∏–Ω–∫–∞—Ö. –°–æ—Ö—Ä–∞–Ω–∏—Ç–µ, –ø—Ä–∏–≥–æ–¥—è—Ç—Å—è!
–ï—â–µ –Ω–µ—Å–∫–æ–ª—å–∫–æ —Ç—ã—Å—è—á –∏–Ω—Ç–µ—Ä–µ—Å–Ω—ã—Ö –∞–Ω–≥–ª–∏–π—Å–∫–∏—Ö —Å–ª–æ–≤ –∏ –≤—ã—Ä–∞–∂–µ–Ω–∏–π –≤ –≥—Ä—É–ø–ø–µ: http://vk.com/skyeng

–ù–æ–≤—ã–µ —Ñ—Ä–∞–∑—ã –∫–∞–∂–¥—ã–π –¥–µ–Ω—å. –ú—ã –≤—Å–µ–≥–¥–∞ –Ω–∞–π–¥–µ–º, —á–µ–º —É–¥–∏–≤–∏—Ç—å - –ø–æ–¥–ø–∏—Å—ã–≤–∞–π—Ç–µ—Å—å.",0,1059,230,1289
1583942411,"üéÅ –†–µ–±—è—Ç, –º—ã —Ç—É—Ç –∫–æ–Ω–∫—É—Ä—Å –∑–∞—Ç–µ—è–ª–∏. –ü–æ–¥–∞—Ä–∏–º 2 –ë–ï–°–ü–õ–ê–¢–ù–´–• —É—Ä–æ–∫–∞ –ø–æ–±–µ–¥–∏—Ç–µ–ª—é. 
–ß—Ç–æ –Ω—É–∂–Ω–æ —Å–¥–µ–ª–∞—Ç—å: 
1. –ë—ã—Ç—å –ø–æ–¥–ø–∏—Å—á–∏–∫–æ–º Skyeng. 
2. –û—Å—Ç–∞–≤–∏—Ç—å –∫–æ–º–º–µ–Ω—Ç–∞—Ä–∏–π –∫ –ø–æ—Å—Ç—É ¬´–≥–æ—Ç–æ–≤–æ¬ª.
3. –ü–æ—Å—Ç–∞–≤–∏—Ç—å –ª–∞–π–∫ –∫ –ø–æ—Å—Ç—É.
4. –†–∞–∑—ã–≥—Ä–∞–µ–º 2 —É—Ä–æ–∫–∞ —Å—Ä–µ–¥–∏ –≤—Å–µ—Ö, –∫—Ç–æ –≤—ã–ø–æ–ª–Ω–∏–ª —É—Å–ª–æ–≤–∏—è 18 –º–∞—Ä—Ç–∞. 

P.S. –ü–æ–±–µ–¥–∏—Ç–µ–ª—è –≤—ã–±–µ—Ä–µ–º —Å–ª—É—á–∞–π–Ω—ã–º –æ–±—Ä–∞–∑–æ–º.",661,586,8,1255
1593871472,"58 —Ñ—Ä–∞–∑–æ–≤—ã—Ö –≥–ª–∞–≥–æ–ª–æ–≤ –Ω–∞ –≤—Å–µ —Å–ª—É—á–∞–∏ –∂–∏–∑–Ω–∏! 

–ë–µ–∑ —Ñ—Ä–∞–∑–æ–≤—ã—Ö –≥–ª–∞–≥–æ–ª–æ–≤ –º–æ–∂–Ω–æ –ø–æ–Ω–∏–º–∞—Ç—å —Ç–æ–ª—å–∫–æ —Å–∞–º—ã–µ –±–∞–∑–æ–≤—ã–µ –∞–Ω–≥–ª–∏–π—Å–∫–∏–µ –≤—ã—Ä–∞–∂–µ–Ω–∏—è. –ü–æ—Ä–æ–π –∑–Ω–∞—á–µ–Ω–∏–µ –≤—Å–µ–π —Ñ—Ä–∞–∑—ã –∑–∞–≤–∏—Å–∏—Ç –æ—Ç –ø—Ä–µ–¥–ª–æ–≥–∞ –∏–ª–∏ –Ω–∞—Ä–µ—á–∏—è. –ú—ã —Å–æ–±—Ä–∞–ª–∏ —Å–∞–º—ã–µ —Ä–∞—Å–ø—Ä–æ—Å—Ç—Ä–∞–Ω–µ–Ω–Ω—ã–µ —Ñ—Ä–∞–∑–æ–≤—ã–µ –≥–ª–∞–≥–æ–ª—ã ‚Äî —Å–æ—Ö—Ä–∞–Ω—è–π—Ç–µ –∏—Ö, —á—Ç–æ–±—ã –æ–Ω–∏ –≤—Å–µ–≥–¥–∞ –±—ã–ª–∏ –ø–æ–¥ —Ä—É–∫–æ–π. 
‚†Ä
–•–æ—Ç–∏—Ç–µ –±–æ–ª—å—à–µ –ø–æ–¥–æ–±–Ω—ã—Ö –∫–∞—Ä—Ç–æ—á–µ–∫? –°—Ç–∞–≤—å—Ç–µ ‚ûï –≤ –∫–æ–º–º–µ–Ω—Ç–∞—Ä–∏—è—Ö.",69,955,203,1227
1560929039,"–¢–µ–ø–µ—Ä—å –≤—ã –∑–Ω–∞–µ—Ç–µ, –∫–∞–∫ –æ—Ç–≤–µ—á–∞—Ç—å:
‚Äì How are you? 
‚Äì I'm OK, I'm not alcoholic.",132,1024,31,1187
1609318604,"–ù–æ–≤–æ–≥–æ–¥–Ω–∏–π —Å–ª–æ–≤–∞—Ä–∏–∫: 36 –ø—Ä–∞–∑–¥–Ω–∏—á–Ω—ã—Ö –∞–Ω–≥–ª–∏–π—Å–∫–∏—Ö —Å–ª–æ–≤ –≤ –≤–∞—à—É –∫–æ–ø–∏–ª–∫—É üá¨üáßüéÑ

–û—Ç–≤–ª–µ–∫–∏—Ç–µ—Å—å –æ—Ç —Å–ø–∏—Å–∫–∞ –ø—Ä–∞–∑–¥–Ω–∏—á–Ω—ã—Ö –¥–µ–ª –∏ –ø–æ—Å–º–æ—Ç—Ä–∏—Ç–µ –Ω–∞—à –Ω–æ–≤–æ–≥–æ–¥–Ω–∏–π —Å–ø–∏—Å–æ–∫ —Å–ª–æ–≤: –æ–Ω–∏ –ø–æ–º–æ–≥—É—Ç –≤–∞–º –ø–æ–∑–¥—Ä–∞–≤–∏—Ç—å –¥—Ä—É–∑–µ–π –∏–∑ –¥—Ä—É–≥–∏—Ö —Å—Ç—Ä–∞–Ω –∏ –ø–æ–Ω—è—Ç—å –Ω–æ–≤–æ–≥–æ–¥–Ω–∏–µ –ø–æ–∑–¥—Ä–∞–≤–ª–µ–Ω–∏—è –æ—Ç –Ω–æ—Å–∏—Ç–µ–ª–µ–π —è–∑—ã–∫–∞.

–°–æ—Ö—Ä–∞–Ω—è–π—Ç–µ —Å–µ–±–µ üìå",0,655,517,1172
1417540800,"100 –∞–Ω–≥–ª–∏–π—Å–∫–∏—Ö —Ñ—Ä–∞–∑ –¥–ª—è –ø—É—Ç–µ—à–µ—Å—Ç–≤–∏–π
–≠—Ç–∏ —Ñ—Ä–∞–∑—ã –≤—ã—Ä—É—á–∞—Ç –≤ –ª—é–±–æ–º –º–µ—Å—Ç–µ. –°–æ—Ö—Ä–∞–Ω–∏—Ç–µ, –ø—Ä–∏–≥–æ–¥–∏—Ç—Å—è.

Could you tell me how to get to the ...? - –í—ã –Ω–µ –ø–æ–¥—Å–∫–∞–∂–µ—Ç–µ, –∫–∞–∫ –¥–æ–±—Ä–∞—Ç—å—Å—è –¥–æ‚Ä¶?
Do you know where the ... is? - –í—ã –Ω–µ –∑–Ω–∞–µ—Ç–µ, –≥–¥–µ –Ω–∞—Ö–æ–¥–∏—Ç—Å—è‚Ä¶?
How far is the‚Ä¶? - –ö–∞–∫ –¥–∞–ª–µ–∫–æ –¥–æ‚Ä¶?
airport - –∞—ç—Ä–æ–ø–æ—Ä—Ç
train station - –∂–µ–ª–µ–∑–Ω–æ–¥–æ—Ä–æ–∂–Ω—ã–π –≤–æ–∫–∑–∞–ª
bus station - –∞–≤—Ç–æ–±—É—Å–Ω–∞—è —Å—Ç–∞–Ω—Ü–∏—è
Can you show me on the map? - –í—ã –º–æ–∂–µ—Ç–µ –ø–æ–∫–∞–∑–∞—Ç—å –º–Ω–µ –Ω–∞ –∫–∞—Ä—Ç–µ?
I'm looking for this address - –Ø –∏—â—É —ç—Ç–æ—Ç –∞–¥—Ä–µ—Å
It's this way - –≠—Ç–æ —Å—é–¥–∞
It's that way - –≠—Ç–æ —Ç—É–¥–∞
You're going the wrong way - –í—ã –∏–¥–µ—Ç–µ –Ω–µ –≤ —Ç—É —Å—Ç–æ—Ä–æ–Ω—É
Take this road - –°–ª–µ–¥—É–π—Ç–µ –ø–æ —ç—Ç–æ–π –¥–æ—Ä–æ–≥–µ
Turn left - –ü–æ–≤–µ—Ä–Ω–∏—Ç–µ –Ω–∞–ª–µ–≤–æ
Turn right - –ü–æ–≤–µ—Ä–Ω–∏—Ç–µ –Ω–∞–ø—Ä–∞–≤–æ
Go straight ahead - –ò–¥–∏—Ç–µ –ø—Ä—è–º–æ
Take the first turn on the left - –ü–æ–≤–µ—Ä–Ω–∏—Ç–µ –Ω–∞ –ø–µ—Ä–≤–æ–º –ø–æ–≤–æ—Ä–æ—Ç–µ –Ω–∞–ª–µ–≤–æ
Take the second turn on the right - –ü–æ–≤–µ—Ä–Ω–∏—Ç–µ –Ω–∞ –≤—Ç–æ—Ä–æ–º –ø–æ–≤–æ—Ä–æ—Ç–µ –Ω–∞–ø—Ä–∞–≤–æ
Turn left at the crossroads - –ù–∞ –ø–µ—Ä–µ–∫—Ä–µ—Å—Ç–∫–µ –ø–æ–≤–µ—Ä–Ω–∏—Ç–µ –Ω–∞–ø—Ä–∞–≤–æ
Continue straight ahead - –ü—Ä–æ–¥–æ–ª–∂–∞–π—Ç–µ –∏–¥—Ç–∏ (–µ—Ö–∞—Ç—å) –ø—Ä—è–º–æ
You'll pass a park on your left - –°–ª–µ–≤–∞ –±—É–¥–µ—Ç –ø–∞—Ä–∫
Keep going for another‚Ä¶ - –ü—Ä–æ–π–¥–∏—Ç–µ –µ—â–µ‚Ä¶

–í—Å–µ 100 –ø–æ–ª–µ–∑–Ω—ã—Ö —Ñ—Ä–∞–∑ –≤ —Ç—Ä–µ—Ö –∫–∞—Ä—Ç–∏–Ω–∫–∞—Ö! –ï—â–µ –Ω–µ—Å–∫–æ–ª—å–∫–æ —Ç—ã—Å—è—á –ø–æ–ø—É–ª—è—Ä–Ω—ã—Ö –∞–Ω–≥–ª–∏–π—Å–∫–∏—Ö —Å–ª–æ–≤ –∏ –≤—ã—Ä–∞–∂–µ–Ω–∏–π –≤ –≥—Ä—É–ø–ø–µ http://vk.com/skyeng
–ù–æ–≤—ã–µ —Ñ—Ä–∞–∑—ã –∫–∞–∂–¥—ã–π –¥–µ–Ω—å.
–ü—Ä–∏—Å–æ–µ–¥–∏–Ω—è–π—Ç–µ—Å—å, —É—á–∏—Ç–µ, –æ–±—â–∞–π—Ç–µ—Å—å.",0,883,273,1156
1575036060,"‚úÖ–ü—Ä–∏—Å—Ç–∞–≤–∫–∏ –æ—Ç–∫—Ä—ã–≤–∞—é—Ç —Å—Ä–∞–∑—É –º–Ω–æ–≥–æ –Ω–æ–≤—ã—Ö —Å–ª–æ–≤ –ø—Ä–∏ –º–∏–Ω–∏–º—É–º–µ —É—Å–∏–ª–∏–π —Å –≤–∞—à–µ–π —Å—Ç–æ—Ä–æ–Ω—ã. –ß—Ç–æ–±—ã –µ—â–µ –ø—Ä–æ—â–µ –±—ã–ª–æ, –º—ã –≤—Å–µ –Ω–∞—Ä–∏—Å–æ–≤–∞–ª–∏ –Ω–∞ –∫–∞—Ä—Ç–æ—á–∫–∞—Ö.
‚úÖ–ë–ï–°–ü–õ–ê–¢–ù–û–ï –∑–∞–Ω—è—Ç–∏–µ –≤ Skyeng –ø–æ —Å—Å—ã–ª–∫–µ: http://skyeng.ru/go/freezan1212",8,907,184,1099
1582095606,"–ù–∞—à–∏ –º–µ—Ç–æ–¥–∏—Å—Ç—ã —Å–æ—Å—Ç–∞–≤–∏–ª–∏ —á–µ–∫-–ª–∏—Å—Ç: –∫–∞–∫–∏–µ —Ç–µ–º—ã –∞–Ω–≥–ª–∏–π—Å–∫–æ–π –≥—Ä–∞–º–º–∞—Ç–∏–∫–∏ —É—á–∏—Ç—å –Ω–∞ –∫–∞–∂–¥–æ–º —É—Ä–æ–≤–Ω–µ —è–∑—ã–∫–∞. 

üìå–ò –∫–∞–∫ —Ç–æ–ª—å–∫–æ –≤—ã —Å–¥–µ–ª–∞–µ—Ç–µ —Ä–µ–ø–æ—Å—Ç —ç—Ç–æ–π –∑–∞–ø–∏—Å–∏, –∑–∞–ø–∏—à–∏—Ç–µ—Å—å –Ω–∞ –ø–µ—Ä–≤–æ–µ –ë–ï–°–ü–õ–ê–¢–ù–û–ï –∑–∞–Ω—è—Ç–∏–µ –≤ Skyeng –ø–æ —Å—Å—ã–ª–∫–µ: skyeng.ru/go/zan4free",26,889,173,1088
1614434940,"58 —Ñ—Ä–∞–∑–æ–≤—ã—Ö –≥–ª–∞–≥–æ–ª–æ–≤ üî•üá¨üáß

–ú—ã —Å–æ–±—Ä–∞–ª–∏ –≤ –æ–¥–Ω—É –ø–æ–¥–±–æ—Ä–∫—É 58 —Ñ—Ä–∞–∑–æ–≤—ã—Ö –≥–ª–∞–≥–æ–ª–æ–≤ üí£ –Ω–∞ –≤—Å–µ —Å–ª—É—á–∞–∏ –∂–∏–∑–Ω–∏, —á—Ç–æ–±—ã –≤—ã –º–æ–≥–ª–∏ –ª–µ–≥–∫–æ –∑–∞–ø–æ–º–Ω–∏—Ç—å –∏—Ö –∏ –ø–æ–ª—å–∑–æ–≤–∞—Ç—å—Å—è –≤ –ª—é–±–æ–π —Å–∏—Ç—É–∞—Ü–∏–∏. –°–æ—Ö—Ä–∞–Ω—è–π—Ç–µ —Å–µ–±–µ üìå",3,518,526,1047
1585118114,üëâ –ë–µ–∑ –ø–∞–Ω–∏–∫–∏!,38,893,27,958
1576914557,"Skyeng –æ–±—ä—è—Å–Ω—è–µ—Ç –∫–∞–∫ –Ω–µ –∑–∞–ø—É—Ç–∞—Ç—å—Å—è –≤ –∞–Ω–≥–ª–∏–π—Å–∫–æ–π –ø—É–Ω–∫—Ç—É–∞—Ü–∏–∏ –≤ —á–µ—Ç—ã—Ä–µ—Ö –∫–∞—Ä—Ç–∏–Ω–∫–∞—Ö 
üòÑ–£–ø—Ä–∞–≤–ª—è–π—Ç–µ –∑–∞–ø—è—Ç—ã–º–∏, –∞ –Ω–µ –ø–æ–¥—á–∏–Ω—è–π—Ç–µ—Å—å –∏–º.",20,827,99,946
1613116047,"5 –≤–∞–∂–Ω—ã—Ö –ø—Ä–µ–¥–ª–æ–≥–æ–≤ –≤ –∞–Ω–≥–ª–∏–π—Å–∫–æ–º üî•üá¨üáß

–ü—Ä–µ–¥–ª–æ–≥–∏ –≤ –∞–Ω–≥–ª–∏–π—Å–∫–æ–º —á–∞—Å—Ç–æ –Ω–µ —Å–æ–≤–ø–∞–¥–∞—é—Ç —Å —É–ø–æ—Ç—Ä–µ–±–ª–µ–Ω–∏–µ–º –≤ —Ä—É—Å—Å–∫–æ–º —è–∑—ã–∫–µ üìù –ß—Ç–æ–±—ã –≥—Ä–∞–º–æ—Ç–Ω–æ —Å—Ç—Ä–æ–∏—Ç—å –ø—Ä–µ–¥–ª–æ–∂–µ–Ω–∏—è, –Ω–µ–æ–±—Ö–æ–¥–∏–º–æ –Ω–µ –ø—Ä–æ—Å—Ç–æ –∑–∞–∑—É–±—Ä–∏—Ç—å –ø—Ä–µ–¥–ª–æ–≥–∏, –Ω–æ –∏ –Ω–∞—É—á–∏—Ç—å—Å—è –∏—Ö —á—É–≤—Å—Ç–≤–æ–≤–∞—Ç—å.

–°–æ—Ö—Ä–∞–Ω—è–π—Ç–µ –∏ –ø–µ—Ä–µ—á–∏—Ç—ã–≤–∞–π—Ç–µ –∫–∞—Ä—Ç–æ—á–∫–∏ —Ö–æ—Ç—è –±—ã —Ä–∞–∑ –≤ –¥–µ–Ω—å, –∏ –Ω—É–∂–Ω—ã–µ —Å–æ—á–µ—Ç–∞–Ω–∏—è —Å–∞–º–∏ –æ—Ç–ª–æ–∂–∞—Ç—Å—è –≤ –ø–∞–º—è—Ç–∏ üìå",8,474,457,939
1614590078,"–ù–µ –ø—É—Ç–∞–π—Ç–µ –ø—Ä–µ–¥–ª–æ–≥–∏: –ø–æ–ª–µ–∑–Ω—ã–µ –∫–∞—Ä—Ç–æ—á–∫–∏ üá¨üáßüìå

–ó–∞–ø—É—Ç–∞—Ç—å—Å—è –≤ –∞–Ω–≥–ª–∏–π—Å–∫–∏—Ö –ø—Ä–µ–¥–ª–æ–≥–∞—Ö –æ—á–µ–Ω—å –ø—Ä–æ—Å—Ç–æ. –í—Å–µ —ç—Ç–∏ in, on, at —Å –∏—Ö –±–µ—Å–∫–æ–Ω–µ—á–Ω—ã–º–∏ –∑–Ω–∞—á–µ–Ω–∏—è–º–∏ —Å–≤–æ–¥—è—Ç —Å —É–º–∞ ü§Ø

–ß—Ç–æ–±—ã —Å–æ—Ö—Ä–∞–Ω–∏—Ç—å —Å–∞–º–æ–æ–±–ª–∞–¥–∞–Ω–∏–µ –∏ —Ä–∞–∑–æ–±—Ä–∞—Ç—å—Å—è –≤ –ø—Ä–µ–¥–ª–æ–≥–∞—Ö, —Å–æ—Ö—Ä–∞–Ω—è–π—Ç–µ –∫–∞—Ä—Ç–æ—á–∫–∏: –º—ã —É–ø–æ—Ä—è–¥–æ—á–∏–ª–∏ –∏–Ω—Ñ–æ—Ä–º–∞—Ü–∏—é —Ç–∞–∫, —á—Ç–æ–±—ã —É –≤–∞—Å –±–æ–ª—å—à–µ –Ω–µ –≤–æ–∑–Ω–∏–∫–∞–ª–æ –≤–æ–ø—Ä–æ—Å–æ–≤. 

–ê –µ—Å–ª–∏ –≤–æ–ø—Ä–æ—Å—ã –≤—Å–µ –∂–µ –æ—Å—Ç–∞–ª–∏—Å—å, —Å–º–µ–ª–æ –∑–∞–¥–∞–≤–∞–π—Ç–µ –∏—Ö –≤ –∫–æ–º–º–µ–Ω—Ç–∞—Ä–∏—è—Ö ü§ì –í –∫–∞–∫–∏—Ö –∞–Ω–≥–ª–∏–π—Å–∫–∏—Ö –ø—Ä–µ–¥–ª–æ–≥–∞—Ö –≤—ã –ø—É—Ç–∞–µ—Ç–µ—Å—å —á–∞—â–µ –≤—Å–µ–≥–æ?",0,455,477,932
1655394926,"–ß–µ–º –∑–∞–º–µ–Ω–∏—Ç—å –Ω–∞–¥–æ–µ–≤—à–µ–µ ¬´How are you?¬ª 

–ú—ã —Å–æ–±—Ä–∞–ª–∏ 8 –≤–∞—Ä–∏–∞–Ω—Ç–æ–≤ —ç—Ç–æ–∏ÃÜ —Ñ—Ä–∞–∑—ã –¥–ª—è —Ç–µ—Ö, –∫—Ç–æ —Ö–æ—á–µ—Ç —Ä–∞–∑–Ω–æ–æ–±—Ä–∞–∑–∏—Ç—å —Å–≤–æ—é —Ä–µ—á—å –∏ –ª—É—á—à–µ –≤–ª–∞–¥–µ—Ç—å –∞–Ω–≥–ª–∏–∏ÃÜ—Å–∫–∏–º. –õ–∏—Å—Ç–∞–∏ÃÜ—Ç–µ –∫–∞—Ä—Ç–æ—á–∫–∏. –†–µ–ø–æ—Å—Ç, —á—Ç–æ–±—ã —Å–æ—Ö—Ä–∞–Ω–∏—Ç—å!
 
–í—ã –∑–Ω–∞–µ—Ç–µ, –≥–¥–µ –Ω–∞–π–¥–µ—Ç–µ –µ—â–µ –±–æ–ª—å—à–µ –ø–æ–ª–µ–∑–Ω–æ–≥–æ –∏ –∏–Ω—Ç–µ—Ä–µ—Å–Ω–æ–≥–æ :) 
–ù–∞ –∑–∞–Ω—è—Ç–∏—è—Ö –≤ Skyeng. 
 
–ü–µ—Ä–≤–æ–µ ‚Äî –≤–≤–æ–¥–Ω–æ–µ ‚Äî –±–µ—Å–ø–ª–∞—Ç–Ω–æ–µ. –ó–∞–ø–∏—à–∏—Ç–µ—Å—å —á–µ—Ä–µ–∑ [http://vk.me/skyeng|—Å–æ–æ–±—â–µ–Ω–∏—è –≥—Ä—É–ø–ø—ã] –∏ –ø–æ–ª—É—á–∏—Ç–µ 3 —É—Ä–æ–∫–∞ –≤ –ø–æ–¥–∞—Ä–æ–∫. –î–æ –≤—Å—Ç—Ä–µ—á–∏ –Ω–∞ –∑–∞–Ω—è—Ç–∏—è—Ö!",7,531,366,904
1588256830,–ò–¥–µ—è –Ω–∞ –º–∞–π—Å–∫–∏–µ.üí°80 –∏–Ω–æ—Å—Ç—Ä–∞–Ω–Ω—ã—Ö —Ñ–∏–ª—å–º–æ–≤ –¥–ª—è –ø—Ä–æ—Å–º–æ—Ç—Ä–∞ –≤ –æ—Ä–∏–≥–∏–Ω–∞–ª–µ –∏ –Ω–µ —Ç–æ–ª—å–∫–æ. üëáüèª,47,727,121,895
1555683420,"–†–∞–∑ –≤ –Ω–µ–¥–µ–ª—é, –º—ã –∏ [club130552184|Topsify] –ø—Ä–µ–¥–ª–∞–≥–∞–µ–º –≤–∞–º —Ä–µ—à–∏—Ç—å, –∫–∞–∫—É—é –ø–µ—Å–Ω—é —Ä–∞–∑–æ–±—Ä–∞—Ç—å —Å —Ç–æ—á–∫–∏ –∑—Ä–µ–Ω–∏—è –∞–Ω–≥–ª–∏–π—Å–∫–æ–≥–æ. –ü–æ–±–µ–¥–∏—Ç–µ–ª—å –≥–æ–ª–æ—Å–æ–≤–∞–Ω–∏—è –ø—Ä–æ—à–ª–æ–π –Ω–µ–¥–µ–ª–∏ –ø–µ—Å–Ω—è ¬´Chlorine¬ª. https://vk.com/skyeng?w=wall-51890028_25661 

–ü—Ä–∏—Ö–æ–¥–∏—Ç–µ –∑–∞–≤—Ç—Ä–∞ –∑–∞ —Å–≤–µ–∂–µ–π –ø–æ—Ä—Ü–∏–µ–π –º—É–∑—ã–∫–∏ –∏ –ø—Ä–æ–≥–æ–ª–æ—Å—É–π—Ç–µ –∑–∞ –Ω–æ–≤—ã–π —Ä–∞–∑–±–æ—Ä.",27,811,26,864
1599653403,"–ê–Ω–≥–ª–∏–π—Å–∫–∏–µ –ø—Ä–µ–¥–ª–æ–≥–∏ –Ω–µ –ø–æ–¥–¥–∞—é—Ç—Å—è –∫–∞–∫–∏–º-–ª–∏–±–æ –ø—Ä–∞–≤–∏–ª–∞–º ü§∑üèª‚Äç‚ôÄ. –ú–æ–∂–Ω–æ —á–∞—Å–∞–º–∏ –∑—É–±—Ä–∏—Ç—å –∏—Ö, –Ω–æ –ª—É—á—à–µ –ø–æ—Å—Ç–∞—Ä–∞—Ç—å—Å—è –ø–æ–Ω—è—Ç—å –∏ –ø–æ—á—É–≤—Å—Ç–≤–æ–≤–∞—Ç—å, –≥–¥–µ —Å—Ç–∞–≤–∏—Ç—å on, –∞ –≥–¥–µ in.

–ú—ã —Å–¥–µ–ª–∞–ª–∏ —É–¥–æ–±–Ω—ã–µ –∫–∞—Ä—Ç–æ—á–∫–∏ üìù —Å —Å–∞–º—ã–º–∏ —Ä–∞—Å–ø—Ä–æ—Å—Ç—Ä–∞–Ω–µ–Ω–Ω—ã–º–∏ —Ñ—Ä–∞–∑–∞–º–∏ –¥–ª—è —Å–∞–º—ã—Ö –ø–æ–ø—É–ª—è—Ä–Ω—ã—Ö –ø—Ä–µ–¥–ª–æ–≥–æ–≤, —á—Ç–æ–±—ã —É–ø—Ä–æ—Å—Ç–∏—Ç—å –≤–∞–º –∑–∞–¥–∞—á—É.

–°–æ—Ö—Ä–∞–Ω—è–π—Ç–µ –∏ –ø–µ—Ä–µ—á–∏—Ç—ã–≤–∞–π—Ç–µ –∏—Ö —Ö–æ—Ç—è –±—ã —Ä–∞–∑ –≤ –¥–µ–Ω—å ü§ì, –∏ –Ω—É–∂–Ω—ã–µ —Å–æ—á–µ—Ç–∞–Ω–∏—è —Å–∞–º–∏ –æ—Ç–ª–æ–∂–∞—Ç—Å—è –≤ –ø–∞–º—è—Ç–∏! 

–ï—â–µ –ª—É—á—à–µ —Ä–∞–∑–æ–±—Ä–∞—Ç—å—Å—è –≤ –≥—Ä–∞–º–º–∞—Ç–∏–∫–µ –∞–Ω–≥–ª–∏–π—Å–∫–æ–≥–æ —è–∑—ã–∫–∞ –ø–æ–º–æ–∂–µ—Ç —ç—Ç–∞ —Å—Å—ã–ª–∫–∞ üî• https://go.skyeng.ru/ppgrammar",6,703,139,848
1615298700,–°–∏–Ω–æ–Ω–∏–º—ã –∫ —Ñ—Ä–∞–∑–µ ¬´I like¬ª üòç –°–æ—Ö—Ä–∞–Ω—è–π—Ç–µ —Å–µ–±–µ –∏ —Ä–∞—Å—à–∏—Ä—è–π—Ç–µ —Å–ª–æ–≤–∞—Ä–Ω—ã–π –∑–∞–ø–∞—Å.,11,569,258,838
1592669785,"–°–∏–Ω–æ–Ω–∏–º—ã –∫ –ø—Ä–∏–ª–∞–≥–∞—Ç–µ–ª—å–Ω—ã–º happy, good –∏ beautiful. üá¨üáß üëá

–î–ª—è —Ç–æ–≥–æ, —á—Ç–æ–±—ã —Å–∫–∞–∑–∞—Ç—å, —á—Ç–æ —á–µ–ª–æ–≤–µ–∫ —Å—á–∞—Å—Ç–ª–∏–≤—ã–π, —Ö–æ—Ä–æ—à–∏–π –∏–ª–∏ –∫—Ä–∞—Å–∏–≤—ã–π (–∏–ª–∏ –≤—Å–µ —Å—Ä–∞–∑—É), –µ—Å—Ç—å –º–Ω–æ–≥–æ —Å–ª–æ–≤ —Å —Ä–∞–∑–Ω—ã–º–∏ –æ—Ç—Ç–µ–Ω–∫–∞–º–∏ —Å–º—ã—Å–ª–∞. –ü–æ—ç—Ç–æ–º—É –Ω–µ —Å—Ç–µ—Å–Ω—è–π—Ç–µ—Å—å –∏—Å–ø–æ–ª—å–∑–æ–≤–∞—Ç—å –∏—Ö –≤—Å–µ. –ü–æ–≤–µ—Ä—å—Ç–µ, –∫–æ–º–ø–ª–∏–º–µ–Ω—Ç ¬´You're stunning!¬ª –∑–≤—É—á–∏—Ç –≥–æ—Ä–∞–∑–¥–æ –∫—Ä—É—á–µ, —á–µ–º –ø—Ä–∏–µ–≤—à–µ–µ—Å—è beautiful. üòâ",10,694,128,832
1561130880,"–ú—ã –ª—é–±–∏–º —Ä–∞–∑–±–∏—Ä–∞—Ç—å –ö–∞—Ä–¥–∏ –ë–∏. –≠—Ç–æ –∫–∞–∫ –±—É–¥—Ç–æ –≤—ã—É—á–∏–ª –Ω–æ–≤—ã–π —è–∑—ã–∫. 

–¢—Ä–µ–∫ ¬´Press¬ª ‚Äî –¥–∏—Å—Å –Ω–∞ –∂–µ–ª—Ç—É—é –ø—Ä–µ—Å—Å—É –∏ –≤—Å–µ—Ö —Ç–µ—Ö, –∫—Ç–æ –∫—Ä–∏—Ç–∏–∫—É–µ—Ç –ø–µ–≤–∏—Ü—É –≤ –∏–Ω—Ç–µ—Ä–Ω–µ—Ç–µ. –î–∞–≤–∞–π—Ç–µ —Ä–∞–∑–±–∏—Ä–∞—Ç—å—Å—è –∏ –∑–∞—É—á–∏–≤–∞—Ç—å —Ç–µ–∫—Å—Ç, —á—Ç–æ–±—ã –ø–æ–¥–ø–µ–≤–∞—Ç—å –ö–∞—Ä–¥–∏. –≠—Ç–æ –æ—Ç–ª–∏—á–Ω–∞—è —Ç—Ä–µ–Ω–∏—Ä–æ–≤–∫–∞ —Ä–∞–∑–≤–∏—Ç–∏—è —Å–∫–æ—Ä–æ—Å—Ç–∏ —Ä–µ—á–∏ –Ω–∞ –∞–Ω–≥–ª–∏–π—Å–∫–æ–º: –≤—ã –≤–µ–¥—å –±—É–¥–µ—Ç–µ —á–µ—Ç–∫–æ –ø—Ä–æ–≥–æ–≤–∞—Ä–∏–≤–∞—Ç—å –≤—Å–µ —Å–ª–æ–≤–∞, –≤ –æ—Ç–ª–∏—á–∏–µ –æ—Ç –ö–∞—Ä–¥–∏.",79,696,53,828
1588573020,"–•–≤–∞–ª–∏—Ç–µ —Å–µ–±—è —á–∞—â–µ! 

‚ùì –†–∞—Å—Å–∫–∞–∂–∏—Ç–µ, –∫–∞–∫ –≤—ã –ø—Ä–æ–≤–æ–¥–∏—Ç–µ –≤—Ä–µ–º—è –Ω–∞ —Å–∞–º–æ–∏–∑–æ–ª—è—Ü–∏–∏. –ü—Ä–æ–π–¥–∏—Ç–µ –æ–ø—Ä–æ—Å: ¬´–ö–∞–∫ –≤—ã —Å–æ–≤–º–µ—â–∞–µ—Ç–µ –æ—Ç–¥—ã—Ö –∏ —Ä–∞–±–æ—Ç—É –Ω–∞ –∫–∞—Ä–∞–Ω—Ç–∏–Ω–µ¬ª –∏ –ø–æ–ª—É—á–∏—Ç–µ –ø–æ–¥–∞—Ä–∫–∏ –ø–æ —Å—Å—ã–ª–∫–µ: skyeng.ru/go/vkarantin",22,719,70,811
1567234808,"üòÉ–ë–∏–ª–ª–∏ –ê–π–ª–∏—à –ø—Ä–æ—Å–ø–∞–ª–∞ –ø—Ä–µ–º–∏—é Video Music Awards –≤ –†–æ—Å—Å–∏–∏. 
‚†Ä 
–¢–∞–∫ –∏ –Ω–∞–ø–∏—Å–∞–ª–∞ –≤ —Å–≤–æ–µ–º –∏–Ω—Å—Ç–∞–≥—Ä–∞–º: ""i was asleep in russia for the awards lmao"". –ß—Ç–æ–±—ã –ø–æ–Ω–∏–º–∞—Ç—å –µ–µ –ø–æ—Å—Ç—ã –Ω—É–∂–Ω–æ —Ä–∞–∑–æ–±—Ä–∞—Ç—å —Ä–∞–∑–Ω–∏—Ü—É –º–µ–∂–¥—É asleep –∏ sleep. 
‚†Ä 
‚û° SLEEP 
Sleep –ø–µ—Ä–µ–≤–æ–¥–∏—Ç—Å—è –≥–ª–∞–≥–æ–ª–æ–º ¬´—Å–ø–∞—Ç—å¬ª –∏–ª–∏ —Å—É—â–µ—Å—Ç–≤–∏—Ç–µ–ª—å–Ω—ã–º ¬´—Å–æ–Ω¬ª. 
‚†Ä 
- I couldn‚Äôt sleep last night because of the noise ‚Äî –Ø –≤—á–µ—Ä–∞ –Ω–µ –º–æ–≥ –Ω–æ—Ä–º–∞–ª—å–Ω–æ —Å–ø–∞—Ç—å –∏–∑-–∑–∞ —à—É–º–∞. 
- My brother talks in his sleep sometimes ‚Äî –ú–æ–π –±—Ä–∞—Ç –∏–Ω–æ–≥–¥–∞ —Ä–∞–∑–≥–æ–≤–∞—Ä–∏–≤–∞–µ—Ç –≤–æ —Å–Ω–µ. 
‚†Ä 
–ì–ª–∞–≥–æ–ª to sleep —á–∞—Å—Ç–æ –∏—Å–ø–æ–ª—å–∑—É—é—Ç –≤–º–µ—Å—Ç–µ —Å —Ç–∞–∫–∏–º–∏ –Ω–∞—Ä–µ—á–∏—è–º–∏, –∫–∞–∫ well, badly, deeply, late. 
‚†Ä 
- I like to sleep late at the weekend ‚Äî –Ø –ª—é–±–ª—é –ø–æ—Å–ø–∞—Ç—å –ø–æ–¥–æ–ª—å—à–µ –Ω–∞ –≤—ã—Ö–æ–¥–Ω—ã—Ö. 
- Did you sleep well last night? ‚Äî –¢—ã —Ö–æ—Ä–æ—à–æ —Å–ø–∞–ª–∞ –ø—Ä–æ—à–ª–æ–π –Ω–æ—á—å—é? 
‚†Ä 
–°—É—â–µ—Å—Ç–≤–∏—Ç–µ–ª—å–Ω–æ–µ sleep —á–∞—Å—Ç–æ –º–æ–∂–Ω–æ –≤—Å—Ç—Ä–µ—Ç–∏—Ç—å —Å –≥–ª–∞–≥–æ–ª–∞–º–∏ to get, to have, to go to, to send to, to fall into. 
‚†Ä 
- His lecture sent me to sleep ‚Äî –ï–≥–æ –ª–µ–∫—Ü–∏—è –º–µ–Ω—è —É—Å—ã–ø–∏–ª–∞. 
- You need to get some sleep, you look really tired. ‚Äî –¢–µ–±–µ –Ω—É–∂–Ω–æ –ø–æ—Å–ø–∞—Ç—å, –≤—ã–≥–ª—è–¥–∏—à—å –æ—á–µ–Ω—å —É—Å—Ç–∞–≤—à–∏–º. 
‚†Ä 
‚û° ASLEEP 
Asleep ‚Äî –ø—Ä–∏–ª–∞–≥–∞—Ç–µ–ª—å–Ω–æ–µ ¬´—Å–ø—è—â–∏–π¬ª. –û–Ω–æ –Ω–∏–∫–æ–≥–¥–∞ –Ω–µ –∏—Å–ø–æ–ª—å–∑—É–µ—Ç—Å—è –ø–µ—Ä–µ–¥ —Å—É—â–µ—Å—Ç–≤–∏—Ç–µ–ª—å–Ω—ã–º–∏, —Ç–æ–ª—å–∫–æ –ø–æ—Å–ª–µ –≥–ª–∞–≥–æ–ª–æ–≤ –∏–ª–∏ –≥–ª–∞–≥–æ–ª–æ–≤-—Å–≤—è–∑–æ–∫ –≤—Ä–æ–¥–µ to be. –í –±–æ–ª—å—à–∏–Ω—Å—Ç–≤–µ —Å–ª—É—á–∞–µ–≤ –Ω–∞ —Ä—É—Å—Å–∫–∏–π –ø–µ—Ä–µ–≤–æ–¥–∏–º –≥–ª–∞–≥–æ–ª–æ–º ¬´—Å–ø–∞—Ç—å¬ª. 
‚†Ä 
- The baby is asleep upstairs. ‚Äî –ú–∞–ª—ã—à —Å–ø–∏—Ç –Ω–∞–≤–µ—Ä—Ö—É. 
- I was asleep in Russia for the awards lmao ‚Äî –Ø —Å–ø–∞–ª–∞ –≤ –†–æ—Å—Å–∏–∏, –∫–æ–≥–¥–∞ –±—ã–ª–∞ –ø—Ä–µ–º–∏—è lmao. 
–ü–æ–ª–µ–∑–Ω–æ–µ –≤—ã—Ä–∞–∂–µ–Ω–∏–µ to fall asleep ‚Äî –∑–∞—Å–Ω—É—Ç—å: 
‚†Ä 
- I fell asleep watching the new film ‚Äî –Ø –∑–∞—Å–Ω—É–ª–∞, —Å–º–æ—Ç—Ä—è –Ω–æ–≤—ã–π —Ñ–∏–ª—å–º.",58,727,24,809
1611040740,"–í —á–µ–º —Ä–∞–∑–Ω–∏—Ü–∞ –º–µ–∂–¥—É —Å–ª–æ–≤–∞–º–∏ say, tell, speak –∏ talk? –†–∞—Å—Å–∫–∞–∑—ã–≤–∞–µ–º –≤—Å–µ –æ –≥–ª–∞–≥–æ–ª–∞—Ö –≥–æ–≤–æ—Ä–µ–Ω–∏—è üá¨üáß

‚úÖ Say ‚Äî ¬´—Å–∫–∞–∑–∞—Ç—å¬ª vs. tell ‚Äî ¬´—Ä–∞—Å—Å–∫–∞–∑–∞—Ç—å¬ª

Say –ø–æ–¥—Ö–æ–¥–∏—Ç, —á—Ç–æ–±—ã –≤—ã—Å–∫–∞–∑–∞—Ç—å –º–Ω–µ–Ω–∏–µ, –ø—Ä–µ–¥–ª–æ–∂–µ–Ω–∏–µ, —Å–æ–æ–±—â–∏—Ç—å —Ñ–∞–∫—Ç. –≠—Ç–æ –∫–æ—Ä–æ—Ç–∫–æ–µ –≤—ã—Å–∫–∞–∑—ã–≤–∞–Ω–∏–µ ‚Äî –æ–¥–Ω–æ —Å–ª–æ–≤–æ, –∫–∞–∫ –≤–æ —Ñ—Ä–∞–∑–∞—Ö to say no (–æ—Ç–∫–∞–∑–∞—Ç—å) –∏ to say hi (–ø–æ–∑–¥–æ—Ä–æ–≤–∞—Ç—å—Å—è), –∏–ª–∏ –æ–¥–Ω–æ-–¥–≤–∞ –ø—Ä–µ–¥–ª–æ–∂–µ–Ω–∏—è: ¬´You said you didn‚Äôt want the last cupcake. I definitely heard that¬ª (¬´–¢—ã —Å–∫–∞–∑–∞–ª, —á—Ç–æ –Ω–µ —Ö–æ—á–µ—à—å –ø–æ—Å–ª–µ–¥–Ω–∏–π –∫–∞–ø–∫–µ–π–∫. –Ø —Ç–æ—á–Ω–æ —ç—Ç–æ —Å–ª—ã—à–∞–ª¬ª). –í –ø—Ä—è–º–æ–π —Ä–µ—á–∏, –∫–æ–≥–¥–∞ –ø–µ—Ä–µ–¥–∞–µ–º –¥–æ—Å–ª–æ–≤–Ω–æ —Å–ª–æ–≤–∞ –¥—Ä—É–≥–æ–≥–æ —á–µ–ª–æ–≤–µ–∫–∞, —Ç–æ–∂–µ –Ω—É–∂–µ–Ω say.

Tell ‚Äî —Ä–∞—Å—Å–∫–∞–∑–∞—Ç—å –∏—Å—Ç–æ—Ä–∏—é, —Å–æ–æ–±—â–∏—Ç—å –∏–Ω—Ñ–æ—Ä–º–∞—Ü–∏—é. –≠—Ç–æ –ø—Ä–æ –±–æ–ª–µ–µ –¥–ª–∏–Ω–Ω—ã–µ –≤—ã—Å–∫–∞–∑—ã–≤–∞–Ω–∏—è: ¬´And then he told me how he had got the job by lying about his level of English¬ª (¬´–ê –ø–æ—Ç–æ–º –æ–Ω —Ä–∞—Å—Å–∫–∞–∑–∞–ª –º–Ω–µ, –∫–∞–∫ –ø–æ–ª—É—á–∏–ª —Ä–∞–±–æ—Ç—É, —Å–æ–≤—Ä–∞–≤ –æ —Å–≤–æ–µ–º —É—Ä–æ–≤–Ω–µ –∞–Ω–≥–ª–∏–π—Å–∫–æ–≥–æ¬ª).

‚úÖ Speak ‚Äî –≥–æ–≤–æ—Ä–∏—Ç—å vs. talk ‚Äî —Ä–∞–∑–≥–æ–≤–∞—Ä–∏–≤–∞—Ç—å

Speak ‚Äî –ø—Ä–æ —Ä–∞–∑–≥–æ–≤–æ—Ä—ã —Å –Ω–µ–∑–Ω–∞–∫–æ–º—ã–º–∏ –ª—é–¥—å–º–∏ –∏ –æ–±—â–µ–Ω–∏–µ –≤ –æ—Ñ–∏—Ü–∏–∞–ª—å–Ω–æ–π –æ–±—Å—Ç–∞–Ω–æ–≤–∫–µ. –ú–µ–Ω–µ–¥–∂–µ—Ä —Ä–µ—Å—Ç–æ—Ä–∞–Ω–∞, —Å–ø–∏–∫–µ—Ä –Ω–∞ –∫–æ–Ω—Ñ–µ—Ä–µ–Ω—Ü–∏–∏ –ø–æ –º–∞—Ä–∫–µ—Ç–∏–Ω–≥—É ‚Äî —ç—Ç–æ –≤—Å–µ —Å—é–¥–∞. –ï—Å–ª–∏ –Ω–∞ —Ä—É—Å—Å–∫–æ–º –≤—ã –±—ã –æ–±—â–∞–ª–∏—Å—å –Ω–∞ ¬´–≤—ã¬ª, –æ–¥–Ω–æ–∑–Ω–∞—á–Ω–æ –Ω—É–∂–µ–Ω speak: ¬´The President refused to speak to reporters¬ª (¬´–ü—Ä–µ–∑–∏–¥–µ–Ω—Ç –æ—Ç–∫–∞–∑–∞–ª—Å—è –≥–æ–≤–æ—Ä–∏—Ç—å —Å —Ä–µ–ø–æ—Ä—Ç–µ—Ä–∞–º–∏¬ª).

Talk ‚Äî –ø—Ä–æ –±–æ–ª–µ–µ –Ω–µ—Ñ–æ—Ä–º–∞–ª—å–Ω–æ–µ –æ–±—â–µ–Ω–∏–µ, –∫–æ–≥–¥–∞ –≤—ã –ø–µ—Ä–µ—Ö–æ–¥–∏—Ç–µ –Ω–∞ ¬´—Ç—ã¬ª. –≠—Ç–æ –±–æ–ª—Ç–æ–≤–Ω—è —Å —Å–µ–º—å–µ–π –∏ –¥—Ä—É–∑—å—è–º–∏, –∫–æ–ª–ª–µ–≥–∞–º–∏, —Å–≤–æ–∏–º –ø—Ä–µ–ø–æ–¥–∞–≤–∞—Ç–µ–ª–µ–º –≤ Skyeng: ¬´I talk to my parents on Facetime every week¬ª (¬´–Ø —Ä–∞–∑–≥–æ–≤–∞—Ä–∏–≤–∞—é —Å —Ä–æ–¥–∏—Ç–µ–ª—è–º–∏ –ø–æ —Ñ–µ–π—Å—Ç–∞–π–º—É –∫–∞–∂–¥—É—é –Ω–µ–¥–µ–ª—é¬ª).",2,443,364,809
1591704289,"–ù–∞–ø–∏—à–∏—Ç–µ –≤ –∫–æ–º–º–µ–Ω—Ç–∞—Ä–∏—è—Ö —Ü–∏—Ñ—Ä—É –æ—Ç 1 –¥–æ 7. –§—Ä–∞–∑–∞, –∫–æ—Ç–æ—Ä–∞—è –≤–∞–º –≤—ã–ø–∞–¥–µ—Ç –±—É–¥–µ—Ç –¥–µ–≤–∏–∑–æ–º –≤–∞—à–µ–π –Ω–µ–¥–µ–ª–∏. üëáüèª",74,664,71,809
1450178421,"Skyeng Steps ‚Äî –±–µ—Å–ø–ª–∞—Ç–Ω—ã–π –∫—É—Ä—Å —Ä–∞–∑–≥–æ–≤–æ—Ä–Ω–æ–≥–æ –∞–Ω–≥–ª–∏–π—Å–∫–æ–≥–æ!

–í—ã –Ω–∞—É—á–∏—Ç–µ—Å—å —Å–≤–æ–±–æ–¥–Ω–æ –æ–±—â–∞—Ç—å—Å—è —Å –Ω–æ—Å–∏—Ç–µ–ª—è–º–∏ —è–∑—ã–∫–∞ –≤ –ª—é–±–æ–π —Å–∏—Ç—É–∞—Ü–∏–∏. –ù–æ–≤—ã–µ —É—Ä–æ–∫–∏ –∫–∞–∂–¥—ã–π —á–µ—Ç–≤–µ—Ä–≥ —É –≤–∞—Å –≤ –ø–æ—á—Ç–µ. –ë–µ—Å–ø–ª–∞—Ç–Ω–æ!

–ü–æ–¥–ø–∏—Å—ã–≤–∞–π—Ç–µ—Å—å –Ω–∞ –∫—É—Ä—Å ¬´–ë–æ–ª—Ç–æ–≤–Ω—è –ø–æ-–∞–Ω–≥–ª–∏–π—Å–∫–∏¬ª –ø—Ä—è–º–æ —Å–µ–π—á–∞—Å: http://school.skyeng.ru/steps/?ch=vk",0,658,133,791
1608657060,"5 —Å–∞–º—ã—Ö –≤–∞–∂–Ω—ã—Ö –≤—Ä–µ–º–µ–Ω –≤ –∞–Ω–≥–ª–∏–π—Å–∫–æ–º 

–í –∞–Ω–≥–ª–∏–π—Å–∫–æ–º —è–∑—ã–∫–µ 12 –≤—Ä–µ–º–µ–Ω üò® –ò–ª–∏ 16 ‚Äï –Ω–µ–∫–æ—Ç–æ—Ä—ã–µ –∞–≤—Ç–æ—Ä—ã —É—á–µ–±–Ω–∏–∫–æ–≤ –≤–∫–ª—é—á–∞—é—Ç —Å—é–¥–∞ –µ—â–µ –∏ —É—Å–ª–æ–≤–Ω—ã–µ –ø—Ä–µ–¥–ª–æ–∂–µ–Ω–∏—è.

–•–æ—Ä–æ—à–∏–µ –Ω–æ–≤–æ—Å—Ç–∏: —Ö–æ—Ç—å –±–µ—Å–ø–æ–ª–µ–∑–Ω—ã—Ö –≤—Ä–µ–º–µ–Ω –∏ –Ω–µ—Ç, –Ω–µ –≤—Å–µ –æ–Ω–∏ –æ–¥–∏–Ω–∞–∫–æ–≤–æ –≤–∞–∂–Ω—ã. –ß—Ç–æ–±—ã –¥–µ–ª–∞—Ç—å –ø–µ—Ä–≤—ã–µ —à–∞–≥–∏ –≤ –∞–Ω–≥–ª–∏–π—Å–∫–æ–º ‚Äï –Ω–∞–ø—Ä–∏–º–µ—Ä, —Ä–∞—Å—Å–∫–∞–∑–∞—Ç—å –ø—Ä–æ —Å–µ–±—è –∏ —Å–≤–æ–∏ —Ö–æ–±–±–∏ ‚Äï –¥–æ—Å—Ç–∞—Ç–æ—á–Ω–æ —É–∂–µ –æ–¥–Ω–æ–≥–æ Present Simple. –°–æ—Ö—Ä–∞–Ω—è–π—Ç–µ –∫–∞—Ä—Ç–æ—á–∫–∏ —Å –ø—è—Ç—å—é —Å–∞–º—ã–º–∏ –Ω—É–∂–Ω—ã–º–∏ –≤—Ä–µ–º–µ–Ω–∞–º–∏ –≤ –∞–Ω–≥–ª–∏–π—Å–∫–æ–º üá¨üáß",0,396,381,777
1598247960,"–ê–Ω–≥–ª–∏–π—Å–∫–∏–µ —Å–∏–Ω–æ–Ω–∏–º—ã, –≤ –∫–æ—Ç–æ—Ä—ã—Ö —É–∂–µ –∑–∞–ª–æ–∂–µ–Ω–æ —É—Å–∏–ª–µ–Ω–∏–µ.

very old fashioned ‚Äî –æ—á–µ–Ω—å —Å—Ç–∞—Ä–æ–º–æ–¥–Ω—ã–π ‚Üí archaic ‚Äî –∞—Ä—Ö–∞–∏—á–Ω—ã–π
very open ‚Äî –æ—á–µ–Ω—å –æ—Ç–∫—Ä—ã—Ç—ã–π ‚Üí transparent ‚Äî –ø—Ä–æ–∑—Ä–∞—á–Ω—ã–π
very painful ‚Äî –æ—á–µ–Ω—å –±–æ–ª–µ–∑–Ω–µ–Ω–Ω—ã–π ‚Üí excruciating ‚Äî –º—É—á–∏—Ç–µ–ª—å–Ω—ã–π
very pale ‚Äî –æ—á–µ–Ω—å –±–ª–µ–¥–Ω—ã–π ‚Üí ashen ‚Äî –ø–µ–ø–µ–ª—å–Ω—ã–π
very perfect ‚Äî –ø—Ä–µ–≤–æ—Å—Ö–æ–¥–Ω–æ ‚Üí flawless ‚Äî –±–µ–∑—É–ø—Ä–µ—á–Ω–æ
very poor ‚Äî –æ—á–µ–Ω—å –±–µ–¥–Ω—ã–π ‚Üí destitute ‚Äî –Ω—É–∂–¥–∞—é—â–∏–π—Å—è
very powerful ‚Äî –æ—á–µ–Ω—å –º–æ–≥—É—â–µ—Å—Ç–≤–µ–Ω–Ω—ã–π ‚Üí compelling ‚Äî –Ω–µ–ø—Ä–µ–æ–¥–æ–ª–∏–º—ã–π, –Ω–µ–æ—Ç—Ä–∞–∑–∏–º—ã–π
very pretty ‚Äî –æ—á–µ–Ω—å —Ö–æ—Ä–æ—à–µ–Ω—å–∫–∞—è ‚Üí beautiful ‚Äî –∫—Ä–∞—Å–∏–≤–∞—è
very quick ‚Äî –æ—á–µ–Ω—å –±—ã—Å—Ç—Ä—ã–π ‚Üí rapid ‚Äî –±—ã—Å—Ç—Ä—ã–π
very quiet ‚Äî –æ—á–µ–Ω—å —Ç–∏—Ö–∏–π ‚Üí hushed ‚Äî –ø—Ä–∏–≥–ª—É—à–µ–Ω–Ω—ã–π
very rainy ‚Äî –æ—á–µ–Ω—å –¥–æ–∂–¥–ª–∏–≤–æ ‚Üí pouring ‚Äî –ø—Ä–æ–ª–∏–≤–Ω–æ–π
very rich ‚Äî –æ—á–µ–Ω—å –±–æ–≥–∞—Ç ‚Üí wealthy ‚Äî —Å–æ—Å—Ç–æ—è—Ç–µ–ª—å–Ω—ã–π
very sad ‚Äî –æ—á–µ–Ω—å –≥—Ä—É—Å—Ç–Ω—ã–π ‚Üí sorrowful ‚Äî —Å–∫–æ—Ä–±–Ω—ã–π, –ø–µ—á–∞–ª—å–Ω—ã–π
very scared ‚Äî –æ—á–µ–Ω—å –Ω–∞–ø—É–≥–∞–Ω ‚Üí petrified ‚Äî –æ–∫–∞–º–µ–Ω–µ–ª—ã–π
very scary ‚Äî –æ—á–µ–Ω—å —Å—Ç—Ä–∞—à–Ω–æ ‚Üí chilling ‚Äî —Ö–æ–ª–æ–¥–µ—Ç—å
very serious ‚Äî –æ—á–µ–Ω—å —Å–µ—Ä—å–µ–∑–Ω—ã–π ‚Üí grave ‚Äî —É–≥—Ä–æ–∂–∞—é—â–∏–π, –º—Ä–∞—á–Ω—ã–π
very sharp ‚Äî –æ—á–µ–Ω—å –æ—Å—Ç—Ä—ã–π ‚Üí keen ‚Äî –æ—Å—Ç—Ä—ã–π
very shiny ‚Äî –æ—á–µ–Ω—å –±–ª–µ—Å—Ç—è—â–∏–µ ‚Üí gleaming ‚Äî –º–µ—Ä—Ü–∞—Ç—å, —Å–≤–µ—Ç–∏—Ç—å—Å—è
very short ‚Äî –æ—á–µ–Ω—å –∫–æ—Ä–æ—Ç–∫–∏–π ‚Üí brief ‚Äî –∫—Ä–∞—Ç–∫–∏–π
very shy ‚Äî –æ—á–µ–Ω—å —Å—Ç–µ—Å–Ω–∏—Ç–µ–ª—å–Ω—ã–π ‚Üí timid ‚Äî —Ä–æ–±–∫–∏–π
very simple ‚Äî –æ—á–µ–Ω—å –ø—Ä–æ—Å—Ç–æ–π ‚Üí basic",9,664,102,775
1552739280,"–î—ç–Ω–∏ —Å–æ–±—Ä–∞–ª –¥–ª—è –≤–∞—Å —Å–∞–º—ã–π —Ç–æ–ø–æ–≤—ã–π –∞–º–µ—Ä–∏–∫–∞–Ω—Å–∫–∏–π —Å–ª–µ–Ω–≥. –ó–∞–±–∏—Ä–∞–π—Ç–µ —Å–µ–±–µ, –Ω–µ –±–ª–∞–≥–æ–¥–∞—Ä–∏—Ç–µ. üôåüèª
‚†Ä
1. TO CATCH SOME Z‚ÄôS: to take a nap, to have some sleep
–ü–æ—Å–ø–∞—Ç—å, –ø–æ–¥—Ä–µ–º–∞—Ç—å. –ü–æ—à–ª–æ –æ—Ç –æ–±–æ–∑–Ω–∞—á–µ–Ω–∏—è —Å–Ω–∞ –≤ –∫–æ–º–∏–∫—Å–∞—Ö ‚ÄúZzzz‚Äù.
‚†Ä
Can you turn the music down a bit, I‚Äôm trying to catch some Z‚Äôs
–ù–µ –º–æ–≥ –±—ã —É–±–∞–≤–∏—Ç—å –∑–≤—É–∫ –Ω–µ–º–Ω–æ–≥–æ, —è –ø—ã—Ç–∞—é—Å—å –ø–æ—Å–ø–∞—Ç—å.
‚†Ä
2. ANTSY: impatient, sometimes even nervous
–ù–µ—Ç–µ—Ä–ø–µ–ª–∏–≤—ã–π, –≤–∑–≤–∏–Ω—á–µ–Ω–Ω—ã–π, –≤–µ—Å—å –∫–∞–∫ –Ω–∞ –∏–≥–æ–ª–∫–∞—Ö.
‚†Ä
I‚Äôm getting all antsy waiting for the final ‚ÄúGame of Thrones‚Äù season.
–Ø –≤–µ—Å—å –Ω–∞ –∏–≥–æ–ª–∫–∞—Ö –≤ –æ–∂–∏–¥–∞–Ω–∏–∏ —Ñ–∏–Ω–∞–ª—å–Ω–æ–≥–æ —Å–µ–∑–æ–Ω–∞ ¬´–ò–≥—Ä—ã –ø—Ä–µ—Å—Ç–æ–ª–æ–≤¬ª.
‚†Ä
3. PAPER BELLY: a person who gets easily drunk
–ß–µ–ª–æ–≤–µ–∫, –∫–æ—Ç–æ—Ä—ã–π –Ω–µ —É–º–µ–µ—Ç –ø–∏—Ç—å, –Ω–∞–ø–∏–≤–∞–µ—Ç—Å—è –æ—Ç –æ–¥–Ω–æ–≥–æ –±–æ–∫–∞–ª–∞.
‚†Ä
‚Äî I only had one beer and I‚Äôm already tipsy.
‚Äî Geez, you're such a paper belly...
‚Äî –Ø –≤—ã–ø–∏–ª –≤—Å–µ–≥–æ –æ–¥–Ω–æ –ø–∏–≤–æ –∏ —É–∂–µ —á—É–≤—Å—Ç–≤—É—é —Å–µ–±—è –ø–æ–¥–≤—ã–ø–∏–≤—à–∏–º.
‚Äî –ì–æ—Å–ø–æ–¥–∏, –¥–∞ —Ç—ã –≤–æ–æ–±—â–µ –Ω–µ —É–º–µ–µ—à—å –ø–∏—Ç—å‚Ä¶
‚†Ä
4. TOPE: a mix between ‚Äútotally‚Äù and ‚Äúdope‚Äù, used to describe smth/smb really cool
–ö–æ–º–±–∏–Ω–∞—Ü–∏—è —Å–ª–æ–≤ totally (–∞–±—Å–æ–ª—é—Ç–Ω–æ, —Å–æ–≤–µ—Ä—à–µ–Ω–Ω–æ) –∏ dope (–∫—Ä—É—Ç–æ–π, –∫–ª–µ–≤—ã–π). –¢–∞–∫ –º–æ–∂–Ω–æ –æ–ø–∏—Å–∞—Ç—å —á—Ç–æ-—Ç–æ –∏–ª–∏ –∫–æ–≥–æ-—Ç–æ –Ω–µ—Ä–µ–∞–ª—å–Ω–æ –∫—Ä—É—Ç–æ–µ.
‚†Ä
OMG, your latest tweet is tope.
–û–ú–ì, —Ç–≤–æ–π –ø–æ—Å–ª–µ–¥–Ω–∏–π —Ç–≤–∏—Ç –Ω–µ—Ä–µ–∞–ª—å–Ω–æ –∫—Ä—É—Ç.
‚†Ä
5. TO SIP ONE‚ÄôS TEA: to mind your own business because smth does not concern you
–ï—Å—Ç—å —Å–ª–µ–Ω–≥–æ–≤–æ–µ –≤—ã—Ä–∞–∂–µ–Ω–∏–µ to spill tea ‚Äî –ø—Ä–æ–≥–æ–≤–æ—Ä–∏—Ç—å—Å—è, —Ä–∞—Å—Å–∫–∞–∑–∞—Ç—å –∫–∞–∫–æ–π-—Ç–æ —Å–µ–∫—Ä–µ—Ç, —Å–ø–ª–µ—Ç–Ω–∏. –û—Ç –Ω–µ–≥–æ –ø–æ—à–ª–æ –≤—ã—Ä–∞–∂–µ–Ω–∏–µ —Å –ø—Ä–æ—Ç–∏–≤–æ–ø–æ–ª–æ–∂–Ω—ã–º –∑–Ω–∞—á–µ–Ω–∏–µ–º ‚Äî –Ω–µ –ª–µ–∑—Ç—å –≤ —á—É–∂–∏–µ –¥–µ–ª–∞, –Ω–µ —Å–æ–≤–∞—Ç—å –Ω–∏–∫—É–¥–∞ —Å–≤–æ–π –Ω–æ—Å.
‚†Ä
‚Äî Have you heard that Josh is cheating on Tiffany?
‚Äî I'm just gonna sip my tea because it‚Äôs none of my business.
‚Äî –°–ª—ã—à–∞–ª–∞, —á—Ç–æ –î–∂–æ—à –∏–∑–º–µ–Ω—è–µ—Ç –¢–∏—Ñ—Ñ–∞–Ω–∏?
‚Äî –Ø –Ω–µ –±—É–¥—É —Å–æ–≤–∞—Ç—å —Å–≤–æ–π –Ω–æ—Å –≤ —á—É–∂–∏–µ –¥–µ–ª–∞, –º–µ–Ω—è —ç—Ç–æ –Ω–µ –∫–∞—Å–∞–µ—Ç—Å—è.

–£–∑–Ω–∞–π—Ç–µ, –±–æ–ª—å—à–µ —Å–ª–µ–Ω–≥–∞ –Ω–∞ –±–µ—Å–ø–ª–∞—Ç–Ω–æ–º —É—Ä–æ–∫–µ –∞–Ω–≥–ª–∏–π—Å–∫–æ–≥–æ: http://skyeng.ru/go/vocabvk",28,673,72,773
1560611851,"–í—ã –º–æ–∂–µ—Ç–µ —É—á–∏—Ç—å –∞–Ω–≥–ª–∏–π—Å–∫–∏–π –≤–æ–æ–±—â–µ –±–µ—Å–ø–ª–∞—Ç–Ω–æ –∏ —É—Ö–≤–∞—Ç–∏—Ç—å –º–µ—Ä—á –æ—Ç Skyeng –ø–æ –¥–æ—Ä–æ–≥–µ. 

‚úÖ –î–∞—Ä–∏–º –ø–æ–¥–∞—Ä–∫–∏ —Å–∞–º–æ–º—É –∞–∫—Ç–∏–≤–Ω–æ–º—É —É—á–∞—Å—Ç–Ω–∏–∫—É –≥—Ä—É–ø–ø—ã! 

1. –ü–æ–¥–ø–∏—à–∏—Ç–µ—Å—å –Ω–∞ —É–≤–µ–¥–æ–º–ª–µ–Ω–∏—è –æ –Ω–æ–≤—ã—Ö –ø—É–±–ª–∏–∫–∞—Ü–∏—è—Ö –≤ –Ω–∞—à–µ–π –≥—Ä—É–ø–ø–µ. –¢–∞–∫ –º—ã –Ω–∞–ø–æ–º–Ω–∏–º –æ –Ω–æ–≤–æ–º —Å—É–ø–µ—Ä-–ø–æ–ª–µ–∑–Ω–æ–º –ø–æ—Å—Ç–µ, –∫–æ—Ç–æ—Ä—ã–π —Å–¥–µ–ª–∞–ª–∏ —Å–ø–µ—Ü–∏–∞–ª—å–Ω–æ –¥–ª—è –≤–∞—Å. 

2. –ü–æ–¥–ø–∏—à–∏—Ç–µ—Å—å –Ω–∞ –º–∞—Ä–∞—Ñ–æ–Ω, —Ä–∞—Å—Å—ã–ª–∫—É –±–µ—Å–ø–ª–∞—Ç–Ω—ã—Ö —É—Ä–æ–∫–æ–≤ –∏ —Ä–∞–∑–±–æ—Ä—ã –ø–µ—Å–µ–Ω –∏ —Å–µ—Ä–∏–∞–ª–æ–≤ –Ω–∞ –∞–Ω–≥–ª–∏–π—Å–∫–æ–º: https://vk.com/skyeng?w=app6258612_-51890028

3. –õ–∞–π–∫–∞–π—Ç–µ –ø–æ—Å—Ç—ã, –∫–æ—Ç–æ—Ä—ã–µ –ø—Ä–æ—á–∏—Ç–∞–ª–∏, —Å–æ—Ö—Ä–∞–Ω—è–π—Ç–µ —Å–µ–±–µ, –µ—Å–ª–∏ –Ω–µ—Ç –≤—Ä–µ–º–µ–Ω–∏ –∏–∑—É—á–∏—Ç—å. –ö–æ–º–º–µ–Ω—Ç–∏—Ä—É–π—Ç–µ, –±—ã–ª–æ –≤–∞–º –ø–æ–ª–µ–∑–Ω–æ –∏–ª–∏ –Ω–µ—Ç ‚Äî –≤—Å–µ —ç—Ç–æ –≤—ã –¥–µ–ª–∞–µ—Ç–µ –¥–ª—è —Å–≤–æ–µ–≥–æ –∞–Ω–≥–ª–∏–π—Å–∫–æ–≥–æ. 

–ú—ã –≤—Å–µ –≤–∏–¥–∏–º üòé –∏ –ø–æ –ø–æ–Ω–µ–¥–µ–ª—å–Ω–∏–∫–∞–º –Ω–∞–≥—Ä–∞–∂–¥–∞–µ–º —Å–∞–º–æ–≥–æ —É–º–Ω–æ–≥–æ –∏ –∞–∫—Ç–∏–≤–Ω–æ–≥–æ –ø–æ–¥–ø–∏—Å—á–∏–∫–∞. –ü–æ–¥–∞—Ä–∫–∏ —ç—Ç–æ–π –Ω–µ–¥–µ–ª–∏ ‚Äî 2 —É—Ä–æ–∫–∞ –∞–Ω–≥–ª–∏–π—Å–∫–æ–≥–æ –Ω–∞ –±–∞–ª–∞–Ω—Å –∏ —Ç–æ–ª—Å—Ç–æ–≤–∫–∞ ¬´–∏–Ω–≥–ª–∏—à –∏–∑ –º–∞–π —Å—É–ø–µ—Ä–ø–∞—É—ç—Ä¬ª. üí™üèª
–ó–∞—Ö–æ–¥–∏—Ç–µ –≤ 12:00 –≤ –ø–æ–Ω–µ–¥–µ–ª—å–Ω–∏–∫. –ë—É–¥–µ–º –æ–ø—Ä–µ–¥–µ–ª—è—Ç—å –ø–æ–±–µ–¥–∏—Ç–µ–ª—è!

–õ–∏–¥–µ—Ä—ã —ç—Ç–æ–π –Ω–µ–¥–µ–ª–∏: 
1) [id134503782|–ú–∞—Ä–≥–∞—Ä–∏—Ç–∞ –ö–∞–º–∞–Ω–∏—Ü—ã–Ω–∞] ‚Äì 90 –±–∞–ª–ª–æ–≤ 
2) [id244952156|–ê–ªe–Ω–∞ –í—è—Ç–∫–∏–Ω–∞] ‚Äì 70 –±–∞–ª–ª–æ–≤ 
3) [id346065795|–†–µ–≥–∏–Ω–∞ –ì–∞–ª–ª—è–º–æ–≤–∞] ‚Äì 61 –±–∞–ª–ª 

–ù–∞–ø–∏—à–∏—Ç–µ –≤ –∫–æ–º–º–µ–Ω—Ç–∞—Ä–∏—è—Ö ¬´—É–∑–Ω–∞—Ç—å –±–∞–ª–ª—ã¬ª, –µ—Å–ª–∏ –≤–∞–º –∏–Ω—Ç–µ—Ä–µ—Å–Ω–æ –Ω–∞ –∫–∞–∫–æ–º –≤—ã –º–µ—Å—Ç–µ. üòâ",196,557,2,755
1613550503,"–í —á–µ–º —Ä–∞–∑–Ω–∏—Ü–∞ –º–µ–∂–¥—É must –∏ should? –ê –∫–æ–≥–¥–∞ –∏—Å–ø–æ–ª—å–∑–æ–≤–∞—Ç—å have to? –ß—Ç–æ–±—ã —Ä–∞–∑ –∏ –Ω–∞–≤—Å–µ–≥–¥–∞ —Ä–∞–∑–æ–±—Ä–∞—Ç—å—Å—è –≤ –º–æ–¥–∞–ª—å–Ω—ã—Ö –≥–ª–∞–≥–æ–ª–∞—Ö, —Å–æ—Ö—Ä–∞–Ω—è–π—Ç–µ –Ω–∞—à–∏ –∫–∞—Ä—Ç–æ—á–∫–∏ —Å –æ–±—ä—è—Å–Ω–µ–Ω–∏—è–º–∏ –∏ –ø—Ä–∏–º–µ—Ä–∞–º–∏ üá¨üáß
‚†Ä
–ü–æ–ª–µ–∑–Ω–æ? –°—Ç–∞–≤—å—Ç–µ ‚ûï –≤ –∫–æ–º–º–µ–Ω—Ç–∞—Ä–∏—è—Ö, –µ—Å–ª–∏ –≤–∞–º –Ω—Ä–∞–≤—è—Ç—Å—è —Ç–∞–∫–∏–µ –ø–æ–¥–±–æ—Ä–∫–∏ –∏ –≤—ã —Ö–æ—Ç–µ–ª–∏ –±—ã –∏—Ö –≤–∏–¥–µ—Ç—å —á–∞—â–µ.",32,393,329,754
1593012000,–í –≤–∞—à—É –≤–∏–¥–µ–æ-–∫–æ–ø–∏–ª–∫—É –Ω–∞ –≤—ã—Ö–æ–¥–Ω—ã–µ. üëáüèª,32,654,63,749
1554805320,"–î—ç–Ω–∏ —Å–æ–±—Ä–∞–ª –¥–ª—è –≤–∞—Å —Å–∞–º—ã–π —Ç–æ–ø–æ–≤—ã–π –∞–º–µ—Ä–∏–∫–∞–Ω—Å–∫–∏–π —Å–ª–µ–Ω–≥. –ó–∞–±–∏—Ä–∞–π—Ç–µ —Å–µ–±–µ, –Ω–µ –±–ª–∞–≥–æ–¥–∞—Ä–∏—Ç–µ. üôåüèª
‚†Ä
1. TO CATCH SOME Z‚ÄôS: to take a nap, to have some sleep
–ü–æ—Å–ø–∞—Ç—å, –ø–æ–¥—Ä–µ–º–∞—Ç—å. –ü–æ—à–ª–æ –æ—Ç –æ–±–æ–∑–Ω–∞—á–µ–Ω–∏—è —Å–Ω–∞ –≤ –∫–æ–º–∏–∫—Å–∞—Ö ‚ÄúZzzz‚Äù.
‚†Ä
Can you turn the music down a bit, I‚Äôm trying to catch some Z‚Äôs
–ù–µ –º–æ–≥ –±—ã —É–±–∞–≤–∏—Ç—å –∑–≤—É–∫ –Ω–µ–º–Ω–æ–≥–æ, —è –ø—ã—Ç–∞—é—Å—å –ø–æ—Å–ø–∞—Ç—å.
‚†Ä
2. ANTSY: impatient, sometimes even nervous
–ù–µ—Ç–µ—Ä–ø–µ–ª–∏–≤—ã–π, –≤–∑–≤–∏–Ω—á–µ–Ω–Ω—ã–π, –≤–µ—Å—å –∫–∞–∫ –Ω–∞ –∏–≥–æ–ª–∫–∞—Ö.
‚†Ä
I‚Äôm getting all antsy waiting for the final ‚ÄúGame of Thrones‚Äù season.
–Ø –≤–µ—Å—å –Ω–∞ –∏–≥–æ–ª–∫–∞—Ö –≤ –æ–∂–∏–¥–∞–Ω–∏–∏ —Ñ–∏–Ω–∞–ª—å–Ω–æ–≥–æ —Å–µ–∑–æ–Ω–∞ ¬´–ò–≥—Ä—ã –ø—Ä–µ—Å—Ç–æ–ª–æ–≤¬ª.
‚†Ä
3. PAPER BELLY: a person who gets easily drunk
–ß–µ–ª–æ–≤–µ–∫, –∫–æ—Ç–æ—Ä—ã–π –Ω–µ —É–º–µ–µ—Ç –ø–∏—Ç—å, –Ω–∞–ø–∏–≤–∞–µ—Ç—Å—è –æ—Ç –æ–¥–Ω–æ–≥–æ –±–æ–∫–∞–ª–∞.
‚†Ä
‚Äî I only had one beer and I‚Äôm already tipsy.
‚Äî Geez, you're such a paper belly...
‚Äî –Ø –≤—ã–ø–∏–ª –≤—Å–µ–≥–æ –æ–¥–Ω–æ –ø–∏–≤–æ –∏ —É–∂–µ —á—É–≤—Å—Ç–≤—É—é —Å–µ–±—è –ø–æ–¥–≤—ã–ø–∏–≤—à–∏–º.
‚Äî –ì–æ—Å–ø–æ–¥–∏, –¥–∞ —Ç—ã –≤–æ–æ–±—â–µ –Ω–µ —É–º–µ–µ—à—å –ø–∏—Ç—å‚Ä¶
‚†Ä
4. TOPE: a mix between ‚Äútotally‚Äù and ‚Äúdope‚Äù, used to describe smth/smb really cool
–ö–æ–º–±–∏–Ω–∞—Ü–∏—è —Å–ª–æ–≤ totally (–∞–±—Å–æ–ª—é—Ç–Ω–æ, —Å–æ–≤–µ—Ä—à–µ–Ω–Ω–æ) –∏ dope (–∫—Ä—É—Ç–æ–π, –∫–ª–µ–≤—ã–π). –¢–∞–∫ –º–æ–∂–Ω–æ –æ–ø–∏—Å–∞—Ç—å —á—Ç–æ-—Ç–æ –∏–ª–∏ –∫–æ–≥–æ-—Ç–æ –Ω–µ—Ä–µ–∞–ª—å–Ω–æ –∫—Ä—É—Ç–æ–µ.
‚†Ä
OMG, your latest tweet is tope.
–û–ú–ì, —Ç–≤–æ–π –ø–æ—Å–ª–µ–¥–Ω–∏–π —Ç–≤–∏—Ç –Ω–µ—Ä–µ–∞–ª—å–Ω–æ –∫—Ä—É—Ç.
‚†Ä
5. TO SIP ONE‚ÄôS TEA: to mind your own business because smth does not concern you
–ï—Å—Ç—å —Å–ª–µ–Ω–≥–æ–≤–æ–µ –≤—ã—Ä–∞–∂–µ–Ω–∏–µ to spill tea ‚Äî –ø—Ä–æ–≥–æ–≤–æ—Ä–∏—Ç—å—Å—è, —Ä–∞—Å—Å–∫–∞–∑–∞—Ç—å –∫–∞–∫–æ–π-—Ç–æ —Å–µ–∫—Ä–µ—Ç, —Å–ø–ª–µ—Ç–Ω–∏. –û—Ç –Ω–µ–≥–æ –ø–æ—à–ª–æ –≤—ã—Ä–∞–∂–µ–Ω–∏–µ —Å –ø—Ä–æ—Ç–∏–≤–æ–ø–æ–ª–æ–∂–Ω—ã–º –∑–Ω–∞—á–µ–Ω–∏–µ–º ‚Äî –Ω–µ –ª–µ–∑—Ç—å –≤ —á—É–∂–∏–µ –¥–µ–ª–∞, –Ω–µ —Å–æ–≤–∞—Ç—å –Ω–∏–∫—É–¥–∞ —Å–≤–æ–π –Ω–æ—Å.
‚†Ä
‚Äî Have you heard that Josh is cheating on Tiffany?
‚Äî I'm just gonna sip my tea because it‚Äôs none of my business.
‚Äî –°–ª—ã—à–∞–ª–∞, —á—Ç–æ –î–∂–æ—à –∏–∑–º–µ–Ω—è–µ—Ç –¢–∏—Ñ—Ñ–∞–Ω–∏?
‚Äî –Ø –Ω–µ –±—É–¥—É —Å–æ–≤–∞—Ç—å —Å–≤–æ–π –Ω–æ—Å –≤ —á—É–∂–∏–µ –¥–µ–ª–∞, –º–µ–Ω—è —ç—Ç–æ –Ω–µ –∫–∞—Å–∞–µ—Ç—Å—è.

–ò –ø–æ–¥–∞—Ä–æ–∫: +2 —É—Ä–æ–∫–∞ –∫ –ø–µ—Ä–≤–æ–π –æ–ø–ª–∞—Ç–µ –ø–æ —Å—Å—ã–ª–∫–µ: skyeng.ru/go/vkpromo",41,643,52,736
1622707174,"–ê–Ω–≥–ª–∏–π—Å–∫–∏–µ –ø—Ä–µ–¥–ª–æ–≥–∏ –Ω–µ –ø–æ–¥–¥–∞—é—Ç—Å—è –∫–∞–∫–∏–º-–ª–∏–±–æ –ø—Ä–∞–≤–∏–ª–∞–º ü§∑üèª‚Äç‚ôÄ. –ú–æ–∂–Ω–æ —á–∞—Å–∞–º–∏ –∑—É–±—Ä–∏—Ç—å –∏—Ö, –Ω–æ –ª—É—á—à–µ –ø–æ—Å—Ç–∞—Ä–∞—Ç—å—Å—è –ø–æ–Ω—è—Ç—å –∏ –ø–æ—á—É–≤—Å—Ç–≤–æ–≤–∞—Ç—å, –≥–¥–µ —Å—Ç–∞–≤–∏—Ç—å on, –∞ –≥–¥–µ in. 
 
–ú—ã —Å–¥–µ–ª–∞–ª–∏ —É–¥–æ–±–Ω—ã–µ –∫–∞—Ä—Ç–æ—á–∫–∏ üìù —Å —Å–∞–º—ã–º–∏ —Ä–∞—Å–ø—Ä–æ—Å—Ç—Ä–∞–Ω–µ–Ω–Ω—ã–º–∏ —Ñ—Ä–∞–∑–∞–º–∏ –¥–ª—è —Å–∞–º—ã—Ö –ø–æ–ø—É–ª—è—Ä–Ω—ã—Ö –ø—Ä–µ–¥–ª–æ–≥–æ–≤, —á—Ç–æ–±—ã —É–ø—Ä–æ—Å—Ç–∏—Ç—å –≤–∞–º –∑–∞–¥–∞—á—É. 
 
–°–æ—Ö—Ä–∞–Ω—è–π—Ç–µ –∏ –ø–µ—Ä–µ—á–∏—Ç—ã–≤–∞–π—Ç–µ –∏—Ö —Ö–æ—Ç—è –±—ã —Ä–∞–∑ –≤ –¥–µ–Ω—å ü§ì, –∏ –Ω—É–∂–Ω—ã–µ —Å–æ—á–µ—Ç–∞–Ω–∏—è —Å–∞–º–∏ –æ—Ç–ª–æ–∂–∞—Ç—Å—è –≤ –ø–∞–º—è—Ç–∏! 
 
–ï—â–µ –ª—É—á—à–µ —Ä–∞–∑–æ–±—Ä–∞—Ç—å—Å—è –≤ –≥—Ä–∞–º–º–∞—Ç–∏–∫–µ –∞–Ω–≥–ª–∏–π—Å–∫–æ–≥–æ —è–∑—ã–∫–∞ –ø–æ–º–æ–∂–µ—Ç —ç—Ç–∞ —Å—Å—ã–ª–∫–∞: https://go.skyeng.ru/freelessons21üî•",0,361,374,735
1592829812,"–§—Ä–∞–∑–æ–≤—ã–µ –≥–ª–∞–≥–æ–ª—ã —Å–æ —Å–ª–æ–≤–æ–º get, –∫–æ—Ç–æ—Ä—ã–µ –¥–æ–ª–∂–µ–Ω –∑–Ω–∞—Ç—å –∫–∞–∂–¥—ã–π, –∫—Ç–æ —É—á–∏—Ç –∞–Ω–≥–ª–∏–π—Å–∫–∏–π. 
‚†Ä
–°–æ—Ö—Ä–∞–Ω—è–π—Ç–µ —Å–µ–±–µ. ü§ìüìù",11,622,99,732
